réunion	réunion
verboten	interdit
dann	alors
respekt	respect
ziffer	chiffre
bibel	bible
dänemark	danemark
jude	juif
ontario	ontario
stadion	stade
korsisch	corse
unabhängigkeit	indépendance
wissen	savoir
navale	navale
asteroid	astéroïde
avenue	avenue
andrew	andrew
zeit	temps
anfrage	demande
autoconfirmed	autoconfirmed
aktiv	actif
biographie	biographie
küche	cuisine
peru	pérou
falsch	faux
rayon	rayon
variante	variante
primär	primaire
europa	europe
archäologisch	archéologique
erzählungen	récits
freitag	vendredi
empire	empire
werk	oeuvre
prinzip	principe
zugänglich	accessible
gedanken	pensées
haar	cheveux
uefa	uefa
betreiber	exploitant
theologie	théologie
szene	scène
parcours	parcours
schwer	lourd
entsprechen	correspondre
adler	aigle
begonnen	commencé
enthält	contient
weiß	blanc
wöchentliche	hebdomadaire
normen	normes
espagnole	espagnole
licht	lumière
treppe	escalier
amateure	amateurs
süd	sud
verwaltung	administration
ausstellungen	expositions
olivenbaum	olivier
bevölkerung	population
finden	trouver
plan	plan
einkommen	revenu
ruine	ruine
bogen	arc
französischsprachig	francophone
mächtig	puissant
begleitet	accompagné
engagiert	engagé
hoffmann	hoffmann
wege	chemins
recently	récemment
davis	davis
ekliptik	écliptique
vision	vision
maximilian	maximilien
straßburg	strasbourg
kooperation	coopération
verkaufen	vendre
krankheiten	maladies
noten	notes
unabhängig	indépendant
blumen	fleurs
strömung	courant
bedrohung	menace
aussprache	prononciation
lothar	lothaire
kommt	vient
clermont	clermont
angepasst	adapté
ökologie	écologie
fulda	fulda
gemeinschaft	communauté
tribunal	tribunal
nrw	nrw
million	million
schöpfer	créateur
papst	pape
wolfgang	wolfgang
arena	arène
registrierung	enregistrement
wahlkreis	circonscription
sowjetisch	soviétique
sand	sable
differenz	différence
wiedergefunden	retrouvé
geschichten	histoires
gräfin	comtesse
männer	hommes
einheit	unité
fische	poissons
jena	jena
instrument	instrument
kommunist	communiste
leiter	leiter
aufl	aufl
zyklus	cycle
hälfte	moitié
subjekte	sujets
remix	remix
spielerin	joueuse
vergleichbar	comparable
koordinaten	coordonnées
minute	minute
lp	lp
november	novembre
traditionen	traditions
software	logiciel
experten	experts
äußerst	extrêmement
kopie	copie
zucker	sucre
stücke	pièces
schwarz	noir
benjamin	benjamin
ziffern	chiffres
beitragen	contribuer
org/w/index	org/w/index
repräsentant	représentant
königin	reine
thomas	thomas
genf	genève
könnte	pourrait
raison	raison
gabriel	gabriel
königreich	royaume
strategie	stratégie
theorie	théorie
morgen	matin
ausnahme	exception
qualifizierte	qualifiée
frage	question
hinzufügen	ajouter
präsentieren	présenter
dekoration	décoration
gott	dieu
bezahlen	payer
unbekannt	inconnu
piloten	pilotes
fahrer	conducteur
funktion	fonction
archivierung	archivage
marschall	maréchal
werte	valeurs
neuauflage	réédition
chronologie	chronologie
monarchie	monarchie
geschaffen	créé
bitte	bitte
konstanz	constance
kreis	cercle
sumpf	marais
bruder	frère
pferd	cheval
spezifisch	spécifique
suite	suite
jersey	jersey
ausgehen	sortir
zentrale	centrale
beweis	preuve
metropole	métropole
attaché	attaché
integriert	intégré
alt	vieux
ursula	ursule
barock	baroque
bedingungen	conditions
baron	baron
australien	australie
archipel	archipel
remise	remise
abschluss	clôture
fischer	pêcheur
konstruktionen	constructions
marguerite	marguerite
tempel	temple
riese	géant
liter	litre
xviiie	xviiie
krank	malade
tief	profond
veränderung	changement
reaktion	réaction
fusionierung	fusion
komtur	commandeur
definiert	défini
sichtbar	visible
verlieren	perdre
erfolgreich	réussi
neustadt	neustadt
entfernung	éloignement
formulierung	formulation
diskutieren	discuter
maritim	maritime
bonaparte	bonaparte
minen	mines
virginie	virginie
präsident	président
episoden	épisodes
nürnberger	nürnberger
souverän	souverain
anwesenheit	présence
banlieue	banlieue
alexandre	alexandre
erfahrungen	expériences
recht	droit
andersherum	autrement
verfassung	constitution
voilà	voilà
format	format
maîtrise	maîtrise
grüße	salutations
angekündigt	annoncé
microsoft	microsoft
herzog	duc
abtei	abbaye
montréal	montréal
anerkannt	reconnu
samuel	samuel
menschlich	humain
zentral	central
funktioniert	fonctionne
staaten	états
identität	identité
plateau	plateau
verteilung	répartition
arbitrage	arbitrage
sieben	sept
helfen	aider
traditionell	traditionnel
tournee	tournée
modern	moderne
therapie	thérapie
sicherlich	sûrement
ankunft	arrivée
destination	destination
punk	punk
reguläre	régulière
württemberg	wurtemberg
alain	alain
sicherheit	sécurité
konserven	conserve
produkte	produits
savoyen	savoie
märkte	marchés
witwe	veuve
chemiker	chimiste
meinungen	opinions
verbreitet	répandu
fahne	drapeau
himmelfahrt	ascension
wüste	désert
theresia	thérèse
staat	état
redaktion	rédaction
angekommen	arrivé
kommentar	commentaire
irland	irlande
gedächtnis	mémoire
menge	menge
persönlichkeiten	personnalités
dennoch	néanmoins
ersetzt	remplacé
§	§
komödie	comédie
aspekt	aspect
mühle	moulin
krankenhaus	hôpital
hypothese	hypothèse
manifestation	manifestation
wiedergeburt	renaissance
traktat	traité
limousin	limousin
gefangener	prisonnier
bewerten	évaluer
synonym	synonyme
saiten	cordes
hauptstadt	capitale
allgemeine	allgemeine
informatik	informatique
ursache	cause
appellation	appellation
demokratie	démocratie
pyrenäen	pyrénées
autonomie	autonomie
mobile	mobile
praxis	pratique
handel	commerce
partner	partenaire
preis	prix
gedichte	poèmes
blätter	feuilles
ozean	océan
vier	quatre
geweiht	consacré
denis	denis
schön	beau
kollegium	collège
kombination	combinaison
vergleichung	comparaison
agglomeration	agglomération
schönheit	beauté
verteidigung	défense
früh	tôt
ökonomisch	économique
müsste	devrait
konsequent	conséquent
modifikation	modification
oskar	oscar
tours	tours
organisiert	organisé
schweizerischen	schweizerischen
portugal	portugal
bewegungen	mouvements
abteilung	abteilung
akte	acte
kampf	combat
sichern	sécuriser
hieronymus	jérôme
atp	atp
verfolgung	persécution
individuell	individuel
interessant	intéressant
schmetterling	papillon
rallye	rallye
arbeiter	travailleur
versuch	essai
miami	miami
maximale	maximale
bemerkenswert	remarquable
tisch	table
enthaltend	contenant
anderer	autre
amsterdam	amsterdam
theodor	théodore
sterben	mourir
autorität	autorité
grundsätzlich	fondamentalement
benannt	dénommé
offiziere	officiers
ring	anneau
blau	bleu
periode	période
vierzehn	quatorze
rudolf	rudolf
avec	avec
provenienz	provenance
allein	seul
kaiser	empereur
erziehung	éducation
herren	seigneurs
henry	henry
magdeburg	magdebourg
umfang	périmètre
salz	sel
eltern	parents
norwegisch	norvégien
korea	corée
barre	barre
friedrich	friedrich
jäger	chasseur
partir	partir
lourdes	lourdes
varietäten	variétés
gaulle	gaulle
besucht	visité
indianer	indien
chemisch	chimique
kinder	enfants
départementale	départementale
umgebung	umgebung
kontakt	contact
elektronik	électronique
union	union
verluste	pertes
verbände	verbände
serie	série
sophie	sophie
faktor	facteur
jagd	chasse
piraten	pirates
poitiers	poitiers
weimarer	weimarer
brüder	frères
petersburg	petersbourg
kreise	cercles
insekten	insectes
papier	papier
hilfe	aide
halle	halle
ball	balle
föderation	fédération
anime	anime
london	londres
wappen	armoiries
prokurist	procureur
benedikt	bénédicte
meter	mètre
wolf	loup
dresdner	dresdner
schlesien	silésie
zonen	zones
zerstören	détruire
batterie	batterie
fremder	étranger
beobachtet	observé
branche	branche
jimmy	jimmy
spät	tard
schwestern	sœurs
bilanz	bilan
zerstörung	dévastation
vincent	vincent
publizieren	publier
gefertigt	fabriqué
manifestationen	manifestations
ips	ips
reservat	réserve
alkohol	alcool
bochum	bochum
seit	seit
akkord	accord
zürich	zurich
leuchtturm	phare
firma	firme
leopold	léopold
führung	conduite
aufsteigend	montant
ehefrau	épouse
plötzlich	soudain
filmografie	filmographie
kathedrale	cathédrale
thailand	thaïlande
klar	clair
blockiert	bloqué
zerstört	détruit
gelb	jaune
getrennt	séparé
bla	bla
aufmerksamkeit	attention
auflösung	dissolution
herbst	automne
opposition	opposition
national	national
erkennbar	reconnaissable
engel	ange
wimbledon	wimbledon
revue	revue
entwickeln	développer
kontrolle	contrôle
gitarrist	guitariste
konföderation	confédération
budget	budget
entscheidungen	décisions
massiv	massif
existenz	existence
weingut	domaine
köpfe	têtes
acht	huit
fuchs	renard
verloren	perdu
bundestag	bundestag
ffffff	ffffff
besitzt	possède
informationen	informations
manuskripte	manuscrits
mehrheit	majorité
ruinen	ruines
emissionen	émissions
vorschlag	proposition
sturz	chute
stuttgart	stuttgart
entwickelung	évolution
yves	yves
ralf	ralf
bande	bande
mars	mars
fels	roche
dimension	dimension
adresse	adresse
durchgang	passage
januar	janvier
offizielle	officielle
roussillon	roussillon
eventuell	éventuel
zelt	tente
studierende	étudiants
rhin	rhin
japanisch	japonais
nintendo	nintendo
töten	tuer
belgien	belgique
besançon	besançon
fassade	façade
interesse	intérêt
übersetzt	traduit
turin	turin
landschaften	paysages
)	)
stahl	acier
schallplatten	disques
diploma	diplôme
liebe	amour
spezialisiert	spécialisé
pferde	chevaux
theologe	théologien
kilometer	kilomètre
brücke	pont
abschnitt	section
gemessen	mesuré
glaube	croyance
didier	didier
produktionen	productions
hart	dur
tübingen	tübingen
verbessert	amélioré
karriere	carriere
chicago	chicago
realisierung	réalisation
derrière	derrière
christentum	christianisme
wahrscheinlich	vraisemblable
grenze	frontière
mathematiker	mathématicien
registriert	enregistré
isère	isère
schlüssel	clé
teufel	diable
rinnsal	ruisseau
lee	lee
verdienste	mérites
lewis	lewis
jane	jane
nuklear	nucléaire
initiative	initiative
aufsteigen	monter
intelligenz	intelligence
charlotte	charlotte
petite	petite
schwester	soeur
information	information
slowakei	slovaquie
kompetenzen	compétences
provinz	province
residenz	résidence
patronym	patronyme
effekte	effets
orient	orient
isabelle	isabelle
gesagt	dit
karl	carl
zelle	cellule
meinung	opinion
film	film
fleisch	viande
nba	nba
tokyo	tokyo
adams	adams
kontinent	continent
passagiere	passagers
sprechen	parler
hartmann	hartmann
eintreten	entrer
orgel	orgue
eindruck	impression
fpu	fpu
brasilianer	brésilien
möchte	voudrait
uss	uss
provinzen	provinces
gleichheit	égalité
sonst	sinon
verhindern	empêcher
grenoble	grenoble
russland	russie
psychologie	psychologie
korps	corps
aérienne	aérienne
henri	henri
regelmäßig	régulièrement
konstituiert	constitué
nummer	numéro
aviation	aviation
konrad	konrad
tschechien	tchéquie
ausbildung	apprentissage
niederländisch	néerlandais
rc	rc
friedhof	cimetière
kollegen	collègues
behalten	retenir
kommissar	commissaire
begegnungen	rencontres
effizienz	efficacité
gloire	gloire
anwendungen	applications
stamm	tronc
männlich	mâle
mauer	mur
ddr	ddr
varietät	variété
istanbul	istanbul
werden	devenir
gattungen	genres
breisgau	brisgau
menschlichkeit	humanité
erklären	expliquer
kanadierin	canadienne
regel	règle
fiche	fiche
touristisch	touristique
db	db
streifen	rayures
alphonse	alphonse
bilder	images
botschafter	ambassadeur
langsam	lentement
berliner	berliner
erwachsener	adulte
lieu	lieu
potentielle	potentiel
inventar	inventaire
verteidigen	défendre
produzenten	producteurs
medien	médias
studieren	étudier
kriege	guerres
moslems	musulmans
louis	louis
antworten	répondre
admiral	amiral
erfolgen	réussir
antwort	réponse
vogel	oiseau
im	im
repräsentationen	représentations
effekt	effet
hütte	hutte
diego	diego
statistik	statistique
laufen	courir
jette	jette
verletzt	offensé
religion	religion
abgeleitet	dérivé
www	www
ukraine	ukraine
optik	optique
respektieren	respecter
general	général
österreich	autriche
importe	importe
sechzig	soixante
definition	définition
pennsylvania	pennsylvanie
pedro	pedro
filmen	filmer
ingenieure	ingénieurs
geist	esprit
generation	génération
erfinder	inventeur
leben	vivre
paris	paris
erde	terre
katharina	catherine
untersuchung	untersuchung
forschungen	recherches
napoléon	napoléon
martin	martin
stunde	heure
musiker	musicien
aktivitäten	activités
huldigung	hommage
photographie	photographie
pseudonym	pseudonyme
kanon	canon
enzyklopädisch	encyclopédique
presque	presque
physiker	physicien
freiherr	freiherr
negativ	négatif
existierte	existait
begraben	enterré
verlauf	déroulement
diskurs	discours
erwähnt	mentionné
absicht	intention
jeanne	jeanne
graveur	graveur
neun	neuf
regime	régime
kavallerie	cavalerie
romantisch	romantique
aufnahme	aufnahme
antenne	antenne
sozialistisch	socialiste
damen	dames
block	bloc
existieren	exister
bild	image
konstantinopel	constantinople
norwegen	norvège
konzil	concile
offiziell	officiellement
erkennen	reconnaître
albrecht	albrecht
presse	presse
macht	puissance
philippe	philippe
werkzeuge	outils
geschlagen	battu
grau	gris
verschluss	fermeture
demokratisch	démocratique
persönlichkeit	personnalité
botanik	botanique
versionen	versions
invasion	invasion
prinzipien	principes
ingenieur	ingénieur
daran	daran
wenig	peu
gärten	jardins
archivalien	archives
prüfungen	épreuves
bänder	bandes
jason	jason
qualifikation	qualification
islamisch	islamique
heilbronn	heilbronn
illustration	illustration
bürgerlich	bourgeois
verkauf	vente
hallo	hallo
charta	charte
claude	claude
kontrakt	contrat
gallo	gallo
bringen	apporter
marseille	marseille
emblem	emblème
sklaven	esclaves
landwirtschaft	agriculture
gehört	appartient
drehen	tourner
hugues	hugues
zu	à
produktion	production
beschränkt	restreint
bernhard	bernard
harvard	harvard
stürzen	tomber
clement	clément
strömungen	courants
ungarisch	hongrois
besetzt	occupé
schatten	ombre
wilhelm	wilhelm
denken	penser
welcher	lequel
several	plusieurs
soldat	soldat
verändert	changé
spitze	aiguille
ibn	ibn
nein	non
kopenhagen	copenhague
lippe	lèvre
maurice	maurice
könnten	pourraient
eingefügt	inséré
david	david
kollekte	collecte
historisch	historiquement
kern	noyau
gegen	contre
versorgung	approvisionnement
klinik	clinique
begrüßen	accueillir
toponym	toponyme
lorenz	lorenz
appelle	appelle
niveaus	niveaux
preußen	prusse
rekonstruktion	reconstruction
buchhandlung	librairie
charlie	charlie
eine	une
elektrisch	électrique
vorschlagen	proposer
gebracht	apporté
realisieren	réaliser
ermordet	assassiné
karlsruhe	karlsruhe
belohnung	récompense
orthodox	orthodoxe
basilika	basilique
rapide	rapide
umwelt	environnement
gerecht	juste
andré	andré
treu	fidèle
entstehung	entstehung
iso	iso
designiert	désigné
norm	norme
ausstellung	exposition
rolle	rouleau
dj	dj
testament	testament
kritik	critique
gespielt	joué
stuart	stuart
post	poste
bücher	livres
wälder	forêts
politiker	politicien
konkret	concret
fähig	capable
auvergne	auvergne
statut	statut
charakteristik	caractéristique
erlaubnis	autorisation
massaker	massacre
sultan	sultan
kulturelle	culturelle
philippinen	philippines
schlafzimmer	chambre
piste	piste
johannes	johannes
abfluss	écoulement
münchner	munichois
dichter	poète
stanley	stanley
sekretär	secrétaire
mode	mode
raum	espace
entdecker	découvreur
pfarrei	paroisse
ein	un
erklärung	explication
abend	soirée
gerhard	gerhard
evangelisch	évangélique
siegfried	siegfried
handball	handball
kabinett	cabinet
holstein	holstein
linz	linz
raymond	raymond
spektakel	spectacle
fünfzehn	quinze
rumänien	roumanie
entspricht	équivaut
wachsen	croître
uhr	horloge
wiedergewählt	réélu
clubs	clubs
anciennes	anciennes
alberto	alberto
gordon	gordon
@	@
lyonnais	lyonnais
veränderungen	changements
lüttich	liège
institutionen	institutions
salzburger	salzburger
säule	colonne
medizin	médecine
phase	phase
andenken	souvenir
professionals	professionnels
forum	forum
abenteuer	aventure
tausch	échange
infanterie	infanterie
warum	pourquoi
spezies	espèce
finanzierung	financement
laval	laval
wagner	wagner
kompilation	compilation
integral	intégral
argumentation	argumentation
unternehmer	entrepreneur
ausgeführt	exécuté
industrie	industrie
missionen	missions
akteure	acteurs
graphisch	graphique
zählen	compter
schwelle	seuil
meinem	meinem
ägypten	égypte
☎	☎
clan	clan
illustrationen	illustrations
wörter	mots
notabeln	notables
genre	genre
tiere	animaux
hannover	hanovre
gerd	gerd
xv	xv
antonio	antonio
mund	bouche
sprint	sprint
atlantik	atlantique
dossier	dossier
risiken	risques
gliedmaßen	membres
variationen	variations
durchmesser	diamètre
kanal	canal
gekommen	venu
formel	formule
dietrich	dietrich
achtel	huitième
villeneuve	villeneuve
armenien	arménie
wissenschaftlich	scientifiquement
steine	pierres
realisiert	réalisée
runde	ronde
interessiert	intéressé
turnier	tournoi
par	par
logo	logotype
planeten	planètes
übertragen	transférer
selten	rare
nah	proche
ereignis	événement
konzert	concert
douglas	douglas
religiös	religieux
hielt	tenait
drache	dragon
roland	roland
kreuz	croix
elfenbein	ivoire
identisch	identique
dank	remerciement
gebiete	gebiete
adam	adam
integrieren	intégrer
zugang	accès
josé	josé
sehr	sehr
jung	jeune
lucien	lucien
legion	légion
calais	calais
konsequenzen	conséquences
kamerun	cameroun
fernand	fernand
akten	actes
howard	howard
glockenturm	clocher
leipzig	leipzig
thüringen	thuringe
ausdrücklich	explicitement
zitat	citation
aura	aura
garonne	garonne
verfolgen	poursuivre
lassen	laisser
versailles	versailles
wann	quand
gemeinschaften	communautés
ausgewählt	sélectionné
kultur	culture
formuliert	formulé
rückkehr	rentrée
jahr	annee
gerechtigkeit	justice
modifizieren	modifier
thron	trône
ehess	ehess
marburg	marbourg
billy	billy
video	vidéo
aktionen	actions
dekret	décret
zeremonie	cérémonie
europäisch	européen
usd	usd
kontakte	contacts
nützlich	utile
inspiration	inspiration
kaiserlich	impérial
hören	écouter
wein	vin
buenos	buenos
kulturen	cultures
definieren	définir
ja	oui
gefallen	tombé
ursprünglich	originairement
partie	partie
entfernt	éloigné
gewidmet	dédié
übersetzung	traduction
inseln	îles
druckerei	imprimerie
occidental	occidental
signiert	signé
stumm	muet
form	forme
frankreich	france
akzent	accent
trennung	séparation
berater	conseiller
lokalisierung	localisation
johanna	johanna
schema	schéma
breton	breton
mario	mario
wisconsin	wisconsin
überall	partout
machen	faire
gewollt	voulu
abt	abbé
brigade	brigade
flucht	fuite
untersuchungen	untersuchungen
industrieller	industriel
schüler	écolier
krieg	guerre
stellvertreter	suppléant
arabisch	arabe
punkte	points
rouen	rouen
jacques	jacques
belohnungen	récompenses
neapel	naples
suchen	chercher
exterieur	extérieur
akteur	acteur
baseball	baseball
atelier	atelier
kandidatur	candidature
zellen	cellules
diplomierter	diplômé
enzyklopädie	encyclopédie
mitbegründer	cofondateur
garten	jardin
strassenbahn	tramway
ufer	rive
repertoire	répertoire
reproduktion	reproduction
sammeln	rassembler
verschwunden	disparu
maxi	maxi
tibet	tibet
konflikt	conflit
\frac	\frac
kurze	courte
regen	pluie
zeigen	montrer
verantwortlich	responsable
porträt	portrait
führen	conduire
park	parc
linien	lignes
katze	chat
edgar	edgar
zeugen	témoins
verbindung	connexion
vorpommern	vorpommern
neckar	neckar
touche	touche
sicher	sûr
villa	villa
xviie	xviie
wm	wm
roger	roger
äquator	équateur
magazin	magasin
heinz	heinz
toulon	toulon
dynastie	dynastie
bestimmen	déterminer
stück	morceau
künstlerisch	artistique
vorschläge	propositions
medaillen	médailles
jr	jr
leicht	léger
hügel	colline
gedicht	poème
soldaten	soldats
modell	modèle
kommission	commission
königlich	royal
duo	duo
zurückkehren	retourner
ihn	lui
einfluss	influence
leser	lecteur
gelegentlich	occasionnellement
drittel	tiers
bibliographie	bibliographie
sechs	six
hahn	coq
ausstattung	aménagement
kommentare	commentaires
verwalten	gérer
wahrheit	vérité
dezember	décembre
notwendigkeit	nécessité
möglich	possible
natürlich	naturellement
gleichgewicht	équilibre
ärzte	médecins
zwölf	douze
bäume	arbres
weltrekord	record
dollar	dollar
allemande	allemande
dijon	dijon
offen	ouvert
mehr	mehr
zdf	zdf
organisation	organisation
florenz	florence
kasten	boîte
✉	✉
entdeckungen	découvertes
samstag	samedi
bonjour	bonjour
agieren	agir
obligatorisch	obligatoire
studiert	étudié
besucher	visiteur
komitee	comité
militant	militant
laboratorium	laboratoire
wikimedia	wikimédia
gegenstände	objets
matthias	matthias
jonathan	jonathan
dave	dave
aufmerksam	attentif
welt	monde
säulen	colonnes
venezuela	venezuela
artillerie	artillerie
eindeutig	univoque
administrativ	administratif
monte	monte
aragon	aragon
lublin	lublin
mandat	mandat
eugène	eugène
ergebnis	résultat
folgen	suivre
philosophie	philosophie
nase	nez
bischöfe	évêques
umlaufbahn	orbite
bericht	rapport
ahnung	pressentiment
feldzüge	campagnes
domizil	domicile
duisburg	duisbourg
departements	départements
komisch	comique
moritz	moritz
amateur	amateur
mecklenburg	mecklembourg
boris	boris
schulen	écoles
regiment	régiment
kommandant	commandant
liste	liste
schwierig	difficile
olympisch	olympique
gespräch	entretien
existiert	existe
essen	manger
kollektiv	collectif
urteil	jugement
konsens	consensus
römisch	romain
materie	matière
mauvais	mauvais
explosion	explosion
lösen	dégager
genie	génie
johnson	johnson
vögel	oiseaux
norbert	norbert
konflikte	conflits
romancier	romancier
august	auguste
baden	baigner
funktionen	fonctions
trainer	entraîneur
dauerhaft	durable
mitteleuropa	mitteleuropa
kirche	église
türkei	turquie
thierry	thierry
daniel	daniel
ferdinand	ferdinand
toulouse	toulouse
besonderen	besonderen
louise	louise
wiki	wiki
imponieren	imposer
musikalisch	musical
festung	forteresse
corporation	corporation
herzegowina	herzégovine
dynamisch	dynamique
memoiren	mémoires
wahlkreise	circonscriptions
möglichkeiten	possibilités
einzigartig	unique
ankommen	arriver
feind	ennemi
eponym	éponyme
bruges	bruges
hierarchie	hiérarchie
klassifikation	classification
provence	provence
ulm	ulm
beschreiben	décrire
werbung	publicité
konsultieren	consulter
räume	espaces
stil	style
verbindungen	connexions
planung	planification
küste	côte
iran	iran
abgeordneter	député
jurist	juriste
zeitgenössisch	contemporain
luxemburg	luxembourg
kindheit	enfance
walter	walter
dargestellt	dargestellt
konstruktion	construction
september	septembre
szenen	scènes
beschuldigt	accusé
genetik	génétique
maillot	maillot
ferrari	ferrari
bahnhof	gare
agenten	agents
spiele	jeux
ballon	ballon
seigneurie	seigneurie
energie	énergie
schild	bouclier
codes	codes
häuser	maisons
pfirsich	pêche
gesehen	vu
wichtigkeit	importance
schwierigkeit	difficulté
bezeichnung	dénomination
groß	grand
alice	alice
hund	chien
säure	acide
gallimard	gallimard
kapitän	capitaine
gottfried	gottfried
harald	harald
png	png
polnisch	polonais
österreicher	autrichien
australier	australien
italienisch	italien
eigentum	propriété
zufall	hasard
vendée	vendée
rollen	rouler
bank	banque
zusammensetzung	composition
güter	biens
svg	svg
innsbruck	innsbruck
moskau	moscou
alfred	alfred
markiert	marqué
partizipieren	participer
carolina	carolina
liberale	libéral
orientalisch	oriental
gaston	gaston
maße	mesures
homonymie	homonymie
emile	émile
anfangen	commencer
rd	rd
anthony	anthony
saal	salle
mexiko	mexique
grundlage	fondement
unfall	accident
gouverneur	gouverneur
zukunft	avenir
lausanne	lausanne
bundesliga	bundesliga
sohn	fils
ersetzen	remplacer
dordogne	dordogne
reform	réforme
varianten	variantes
möglicherweise	possiblement
flughafen	aéroport
monat	mois
milch	lait
wörtlich	littéralement
drei	trois
dissertation	thèse
frei	libre
extremität	extrémité
zehnte	dixième
letzter	dernier
operationen	opérations
kolumbien	colombie
frequenz	fréquence
manuskript	manuscrit
universitäten	universités
widerstand	résistance
direktor	directeur
schneider	tailleur
extrakt	extrait
vermeiden	éviter
zivilisation	civilisation
kardinal	cardinal
wuppertal	wuppertal
mönche	moines
angebot	offre
madagaskar	madagascar
camille	camille
saison	saison
quitte	quitte
dunkel	sombre
mohamed	mohamed
diözese	diocèse
senegal	sénégal
bmw	bmw
kärnten	carinthie
eishockey	hockey
verhindert	empêché
habitat	habitat
mai	mai
kommunisten	communistes
fliegen	voler
avignon	avignon
nassau	nassau
entscheidung	décision
ritter	chevalier
anjou	anjou
gregor	grégoire
wagen	wagon
chinesisch	chinois
kroatien	croatie
tafelbilder	tableaux
antwerpen	anvers
selbstmord	suicide
beziehung	relation
hauptsächlich	principalement
infrastruktur	infrastructure
abkürzungen	abréviations
büros	bureaux
hildesheim	hildesheim
gehen	aller
anscheinend	apparentement
roux	roux
west	ouest
spielen	jouer
schriftstellerin	écrivaine
chronik	chronique
ehre	honneur
etablieren	établir
geschickt	habile
rückzug	retraite
gehörten	appartenaient
jpg	jpg
milliarden	milliards
schatz	trésor
portraits	portraits
bremen	brême
besaß	possédait
tragen	porter
kommerziell	commercial
komplex	complexe
nahrung	nourriture
spanisch	espagnol
minnesota	minnesota
epoche	époque
erbe	héritage
frisch	frais
westfalen	westphalie
verstehen	comprendre
nancy	nancy
fernando	fernando
reflexion	réflexion
quentin	quentin
aufzucht	élevage
veröffentlichungen	publications
um	um
match	match
pyramide	pyramide
terrestrisch	terrestre
unterstützen	soutenir
gedacht	pensé
ausgang	sortie
besser	mieux
danke	merci
wilson	wilson
donald	donald
vorwort	préface
jeff	jeff
dauer	durée
holz	bois
gelegenheit	occasion
republik	république
drama	drame
regional	régional
positiv	positif
berlin	berlin
warten	attendre
debatte	débat
salon	salon
bäder	bains
fin	fin
kette	chaîne
konsequenz	conséquence
wurzel	racine
fahrzeug	véhicule
häufig	fréquemment
soi	soi
produkt	produit
blut	sang
pfeil	flèche
elisabeth	élisabeth
madeleine	madeleine
wunsch	souhait
morgan	morgan
verbesserung	amélioration
islam	islam
punkt	point
knoten	nœud
teilweise	partiellement
wasser	eau
technik	technique
depot	dépôt
themen	thèmes
neffe	neveu
niemand	niemand
orchester	orchestre
niederlage	défaite
willy	willy
emmanuel	emmanuel
hélène	hélène
restaurierung	restauration
albert	albert
karten	cartes
dokumentiert	documenté
strassen	rues
quellen	sources
füße	pieds
städtisch	urbain
erzählung	récit
concernant	concernant
alles	tout
rahmen	cadre
sportlich	sportif
krise	crise
anwendung	application
kontext	contexte
fragen	interroger
gotisch	gothique
produzent	producteur
dick	dick
grüß	salut
professionell	professionnel
grotte	grotte
michigan	michigan
akzeptiert	accepté
quai	quai
halb	demi
konservatorium	conservatoire
reduzieren	réduire
brücken	ponts
mord	meurtre
umgekehrt	renversé
kanton	canton
disney	disney
nichts	rien
kantone	cantons
vorbereitung	préparation
ökonomie	économie
nutzlos	inutile
aktion	action
,	,
abhängig	dépendante
wollen	vouloir
abstimmung	abstention
fortschritt	progrès
anpassung	adaptation
interpreter	interprète
erich	erich
zeichner	dessinateur
freunde	amis
andreas	andreas
schreiben	écrire
harry	harry
gas	gaz
missouri	missouri
digital	numérique
cf	cf
geschlossen	fermé
portwein	porto
nîmes	nîmes
netzwerk	réseau
juli	juillet
url	url
volkszählung	recensement
zuschauer	spectateur
felder	champs
präfektur	préfecture
kollaboration	collaboration
hektar	hectare
mannheim	mannheim
plakat	affiche
algerien	algérie
fm	fm
supérieure	supérieure
himmel	ciel
absolut	absolu
chor	chœur
occident	occident
verteidiger	défenseur
michel	michel
nachfolger	successeur
denkmäler	monuments
teilen	partager
victoire	victoire
attentat	attentat
überraschung	surprise
generika	générique
enthalten	contenir
verfahren	procédure
syrien	syrie
vandalismus	vandalisme
orientierung	orientation
etappe	étape
goethe	goethe
jackson	jackson
der	the
empfang	réception
veröffentlichung	publication
münchen	munich
betrifft	concerne
parks	parcs
orthographie	orthographe
beispiele	exemples
unternehmungen	entreprises
angelegenheit	affaire
bedürfnisse	besoins
regie	régie
ankündigung	annonce
etage	étage
album	album
fortes	fortes
renault	renault
fisch	poisson
schwierigkeiten	difficultés
journalisten	journalistes
kategorien	catégories
kpd	kpd
sollten	devraient
kosten	coûter
nicole	nicole
draußen	dehors
arbeiten	travailler
qualifiziert	qualifié
konto	compte
animation	animation
griechenland	grèce
überprüfen	vérifier
schule	école
galerie	galerie
einheiten	unités
hollywood	hollywood
student	étudiant
englische	anglaise
nantes	nantes
technologien	technologies
gesetz	loi
angriffe	attaques
weniger	moins
akkorde	accords
wiesbaden	wiesbaden
marcel	marcel
völker	peuples
uns	nous
welche	quelle
jury	jury
würzburg	wurtzbourg
zeichnungen	dessins
indiana	indiana
behandlung	traitement
elite	élite
prêt	prêt
lösungen	solutions
arles	arles
essentiell	essentiel
robert	robert
besitzen	posséder
zurückgezogen	reculé
früchte	fruits
ähnlich	similaire
reisen	voyager
effizient	efficace
wollten	voulaient
messe	messe
abwesenheit	absence
passant	passant
inschrift	inscription
agent	agent
kopf	tête
republikaner	républicain
maler	peintre
poitou	poitou
konzeption	conception
organismen	organismes
nord	nord
geben	donner
ceci	ceci
soziologie	sociologie
doktorat	doctorat
euch	euch
sehen	voir
öffnen	ouvrir
flotte	flotte
schleswig	schleswig
fotos	photos
wirklich	vraiment
braun	brun
april	avril
südlich	méridional
russisch	russe
bielefeld	bielefeld
ziele	cibles
petit	petit
mikro	micro
juristisch	juridique
bearbeitet	bearbeitet
junior	junior
spielend	jouant
maximum	maximum
klima	climat
kolonie	colonie
arzt	médecin
garçon	garçon
befehl	commandement
hoffnung	espérance
novellen	nouvelles
kommunikation	communication
leichtathletik	athlétisme
coup	coup
bevorzugt	préféré
null	zéro
reise	voyage
seminar	séminaire
prozess	procès
dichte	densité
anderswo	ailleurs
missbrauch	abus
bach	bac
subjekt	sujet
botschaft	ambassade
symphonie	symphonie
inspektor	inspecteur
feinde	ennemis
haben	avoir
werke	oeuvres
stiftung	fondation
professor	professeur
automatik	automatique
meer	mer
sind	sont
belgrad	belgrade
kategorie	catégorie
einführung	introduction
verhalten	comportement
finalistin	finaliste
randbemerkung	remarque
griechen	grecs
krone	couronne
loire	loire
unterricht	enseignement
polizei	police
rund	rond
konstante	constante
montpellier	montpellier
thema	thème
mittelmeer	méditerranée
kredit	crédit
oberst	oberst
zone	zone
heidelberg	heidelberg
alexis	alexis
methode	méthode
gewinner	gagnant
chaussee	chaussée
verlust	perte
schützling	protégé
fiktion	fiction
bulletin	bulletin
cambridge	cambridge
konvention	convention
neuer	nouveau
verschieden	différent
kommando	kommando
brunswick	brunswick
faun	faune
wikipedia	wikipédia
schnell	schnell
kennt	connaît
zugehörigkeit	appartenance
regionale	régionale
diskutiert	discuté
lang	long
verleger	éditeur
nach	après
patrick	patrick
globus	globe
nutzung	utilisation
gut	bon
verliebt	amoureux
dachte	pensait
bildhauer	sculpteur
ausbruch	éruption
koalition	coalition
arnaud	arnaud
ci	ci
hätten	auraient
gruppe	groupe
disziplin	discipline
detail	détail
akzeptieren	accepter
atlas	atlas
fuß	pied
petroleum	pétrole
mailand	milan
vergessen	oublier
wild	sauvage
elemente	éléments
kriterien	critères
marx	marx
alle	tous
madrid	madrid
immer	toujours
bauen	bâtir
maschine	machine
manchester	manchester
karte	carte
option	option
weimar	weimar
orange	orange
universität	université
abstammung	ascendance
lernen	apprendre
tatsachen	faits
wahrnehmung	perception
zeitgenossen	contemporains
gewonnen	gagné
picardie	picardie
dresden	dresde
hoheit	hauteur
beschäftigung	emploi
unterscheiden	distinguer
directe	directe
aisne	aisne
agentur	agence
real	réel
technologie	technologie
unterstützung	soutien
paderborn	paderborn
abgrenzung	délimitation
ruhe	tranquillité
rue	rue
küchenchef	chef
bob	bob
französisch	français
sonntag	dimanche
internet	internet
föderal	fédéral
circulation	circulation
entstehen	naître
kalt	froid
sachsen	saxons
gérard	gérard
geschätzt	estimé
fete	fête
caesar	césar
heilig	sacré
hervorbringen	produire
exposé	exposé
gleich	égal
katalog	catalogue
parlamentarier	parlementaire
kapazität	capacité
präsent	présent
hervé	hervé
regensburg	ratisbonne
intervenieren	intervenir
organismus	organisme
verkauft	vendu
ballett	ballet
simon	simon
herzogtum	duché
vorbereiten	préparer
abo	abo
überwachung	surveillance
präsentiert	présenté
statuen	statues
joachim	joachim
woche	semaine
fabrikation	fabrication
komplett	complètement
trotzdem	malgré
temperatur	température
inspiriert	inspiré
geographie	géographie
#ffffff	#ffffff
jugoslawien	yougoslavie
ausgesprochen	prononcé
bordeaux	bordeaux
bataillon	bataillon
bruce	bruce
nef	nef
bürgermeister	bourgmestre
kyrillisch	cyrillique
tunesien	tunisie
spannung	tension
beschreibung	description
exil	exil
fünfzig	cinquante
adoptiert	adopté
rangliste	classement
ferme	ferme
sed	sed
alex	alex
kasse	caisse
beiträge	beiträge
tschechisch	tchèque
eigenschaften	propriétés
sammlungen	sammlungen
portugiesisch	portugais
leidenschaft	passion
präfekt	préfet
ministerium	ministère
édouard	édouard
aufenthalt	séjour
notieren	noter
wachstum	croissance
hui	hui
rhythmus	rythme
aufstieg	aufstieg
hotel	hôtel
leer	leer
territorien	territoires
konzerte	concerts
schottland	ecosse
fehler	erreur
oktober	octobre
languedoc	languedoc
chemie	chimie
februar	février
anforderungen	exigences
kloster	couvent
chili	chili
name	nom
bretagne	bretagne
durchbruch	percée
bewertung	évaluation
israel	israël
georges	georges
rasse	race
noblesse	noblesse
altar	autel
aspekte	aspects
insel	île
fabrik	fabrique
architektur	architecture
netzwerke	réseaux
revolte	révolte
manga	manga
arthur	arthur
günther	günther
nehmen	prendre
knochen	os
observatorium	observatoire
städte	villes
wesen	essence
verbessern	améliorer
miguel	miguel
sekunde	seconde
glied	membre
hamilton	hamilton
allgemeinen	allgemeinen
dortmund	dortmund
dreißig	trente
stimmen	stimmen
bassin	bassin
toronto	toronto
konservierung	conservation
deutsch	allemand
illustriert	illustré
iv	iv
pflanze	plante
jordan	jordan
griechisch	grec
ketten	chaînes
solide	solide
quadrat	carré
bibliothek	bibliothèque
kaffee	café
warschau	varsovie
objekt	objet
zwischenhändler	intermédiaire
sturm	tempête
befreiung	libération
preisträger	lauréat
eberhard	eberhard
radfahrer	cycliste
erinnerungen	souvenirs
endemisch	endémique
ausführung	exécution
anwalt	avocat
allianz	alliance
monaco	monaco
radio	radio
sitzung	séance
datei	fichier
grün	vert
flugzeuge	avions
senat	sénat
umstritten	controversé
oberbürgermeister	oberbürgermeister
vorteil	avantage
elektrizität	électricité
marco	marco
fehlen	manquer
senator	sénateur
wert	valeur
syndrom	syndrome
auge	œil
woiwodschaft	voïvodie
idem	idem
parole	parole
delegation	délégation
leipziger	leipziger
medaille	médaille
kapital	capital
interpretation	interprétation
übersetzer	traducteur
geschichte	histoire
jerusalem	jérusalem
ancienne	ancienne
stein	pierre
lizenz	licence
schweizer	suisse
erwin	erwin
malerei	peinture
territoriale	territoriale
halbinsel	péninsule
assistent	assistant
literarisch	littéraire
königsberg	königsberg
industrielle	industrielle
trio	trio
komplettieren	compléter
geheimnisse	secrets
gewicht	poids
belgisch	belge
voran	avant
schäden	dégâts
stadt	ville
richter	juge
branches	branches
herbert	herbert
individuum	individu
materialien	matériaux
ohio	ohio
gitarre	guitare
prinzessin	princesse
motoren	moteurs
coups	coups
rektor	recteur
eigentümer	propriétaire
katholisch	catholique
charakter	caractère
äquivalent	équivalent
fussball	football
virus	virus
arbeit	travail
fürst	prince
herz	cœur
vorhergesehen	prévu
fortsetzen	continuer
karoline	caroline
expedition	expédition
wald	forêt
stéphane	stéphane
architekten	architectes
funktionsweise	fonctionnement
herzogin	duchesse
geburtstag	anniversaire
nationen	nations
nouveaux	nouveaux
wladimir	wladimir
server	serveur
doktor	docteur
aachen	aix
angriff	attaque
nürnberg	nuremberg
afrika	afrique
jacob	jacob
bbc	bbc
neutral	neutre
parallele	parallèle
wache	garde
amerikanisch	américain
grenzen	frontières
beschädigt	endommagé
siebente	septième
revolutionär	révolutionnaire
sprachwissenschaft	linguistique
titel	titre
qualität	qualité
diffusion	diffusion
kulturell	culturel
kostüme	costumes
christlich	chrétien
hms	hms
kupfer	cuivre
québécois	québécois
onkel	oncle
mann	homme
synthese	synthèse
jürgen	jürgen
gebäude	bâtiment
faktoren	facteurs
bertrand	bertrand
erscheinen	apparaître
priester	prêtre
freundin	amie
manfred	manfred
asien	asie
boulevard	boulevard
truppe	troupe
fahrzeuge	véhicules
tochterunternehmen	filiale
öl	huile
lissabon	lisbonne
osnabrück	osnabrück
gerichtlich	judiciaire
outre	outre
unser	notre
jesus	jésus
journalist	journaliste
sektor	secteur
millimeter	millimètre
philosoph	philosophe
kongregation	congrégation
partisanen	partisans
freundschaft	amitié
wiederfinden	retrouver
mission	mission
bedürfnis	besoin
elsass	alsace
zufällig	aléatoire
debütieren	débute
parameter	paramètre
schwedisch	suédois
erscheinung	apparition
projekte	projets
haltung	tenue
glocken	clochettes
spieler	joueur
eis	glace
kalender	calendrier
skulptur	sculpture
sammelband	recueil
koblenz	coblence
amiens	amiens
installiert	installé
träger	porteur
stichwahl	scrutin
masse	masse
linux	linux
exekutiv	exécutif
fluss	fleuve
präzision	précision
programmierung	programmation
ausdruck	expression
exzentrizität	excentricité
sebastian	sebastien
motiv	motif
bass	basse
zugeschrieben	attribué
khan	khan
operation	opération
gesetze	lois
maske	masque
reserven	réserves
naja	naja
santa	santa
brüssel	bruxelles
lambert	lambert
choix	choix
serbisch	serbe
nathalie	nathalie
jede	chacune
marke	marque
armee	armée
kongreß	congrès
hameau	hameau
majeur	majeur
wahr	vrai
blues	blues
diskussion	discussion
beziehungen	relations
ausrüstung	équipement
kolonien	colonies
breslau	breslau
restaurant	restaurant
unmöglich	impossible
feuer	feu
angreifer	attaquant
erfurt	erfurt
besonderer	besonderer
korrespondent	correspondant
schlagzeuger	batteur
philip	philip
gefärbt	teinté
angelegenheiten	affaires
dörfer	villages
pole	pôle
usa	usa
blatt	feuille
orléans	orléans
verbrechen	crime
perihel	périhélie
programm	programme
projekt	projet
ausbeutung	exploitation
allemands	allemands
julius	julius
lübeck	lübeck
québec	québec
lothringen	lorraine
kunst	art
versammlung	assemblée
reputation	réputation
stimme	voix
archäologie	archéologie
frankfurter	frankfurter
installation	installation
hamburger	hamburger
drehbuch	scénario
können	können
schließen	fermer
vergnügen	plaisir
paradies	paradis
bestimmt	déterminé
hochgezogen	élevé
autoritäten	autorités
hg	hg
offensichtlich	évident
nachbarn	voisins
verstärkt	renforcé
vorgeschlagen	proposé
mayotte	mayotte
mercedes	mercedes
fünf	cinq
bemerken	remarquer
berühmt	célèbre
mönch	moine
spezialisten	spécialistes
germanisch	germanique
aufbau	aufbau
totalität	totalité
partizip	participe
zitieren	citer
kelly	kelly
symbole	symbole
poesie	poésie
abraham	abraham
zentralen	centrales
entscheidend	décisif
operator	opérateur
inhalt	contenu
pommern	poméranie
sydney	sydney
fotograf	photographe
variation	variation
sekunden	secondes
finnland	finlande
konzept	concept
palmares	palmarès
sncf	sncf
französinnen	françaises
caen	caen
leiden	souffrir
mathematik	mathématique
basiert	basé
tagebuch	journal
kenntnisse	connaissances
nation	nation
budapest	budapest
playstation	playstation
hängen	pendre
tanz	danse
referenz	référence
wichtig	important
salzburg	salzbourg
kapitel	chapitre
doppelt	double
biographisch	biographique
hof	cour
metall	métal
kapelle	chapelle
aufgaben	tâches
antike	antiquité
syndikat	syndicat
bd	bd
serge	serge
kassel	cassel
befördert	promu
manifest	manifeste
recherche	recherche
flugzeug	avion
geheimnis	secret
abstieg	relégation
dokumentation	dokumentation
territorium	territoire
glauben	croire
sieger	vainqueur
musik	musique
fakultät	faculté
valenz	valence
ehrlich	honnête
blume	fleur
roberto	roberto
umgeben	entourer
wärme	chaleur
delegierter	délégué
sämtliche	sämtliche
richtung	direction
alpen	alpes
linie	ligne
kohle	charbon
zwanzig	vingt
ordnung	ordre
eingeführt	introduit
satellit	satellite
phantastisch	fantastique
gipfel	sommet
talent	talent
sinn	sens
champagner	champagne
saisons	saisons
wörterbuch	dictionnaire
km/h	km/h
gesundheit	santé
vogesen	vosges
klub	club
geteilt	partagé
publiziert	publié
legende	légende
johnny	johnny
versichern	assurer
john	john
klassisch	classique
peking	pékin
drehbuchautor	scénariste
schreibtisch	bureau
passagen	passages
haus	maison
sterne	étoiles
autobahn	autoroute
christine	christine
index	indice
limoges	limoges
santiago	santiago
camps	camps
krankheit	maladie
palast	palais
handbuch	manuel
städtische	städtische
johann	johann
schliesslich	finalement
verhandlungen	négociations
situation	situation
marathon	marathon
boston	boston
verletzung	blessure
bischoff	évêque
anti	anti
kult	culte
fédérale	fédérale
astronomen	astronome
bin	bin
dramatisch	dramatique
auf	auf
seele	âme
fdp	fdp
strukturen	structures
profil	profil
gegeben	donné
angleterre	angleterre
anspruch	prétention
francesco	francesco
rekorde	records
international	international
kraft	kraft
kalifornien	californie
tendenz	tendance
ereignisse	événements
cannes	cannes
verheiratet	marié
jenseits	jenseits
spanien	espagne
hoch	haut
reduktion	réduction
relevanz	relevance
mischung	mélange
edits	edits
erzbischof	archevêque
lokomotiven	locomotives
vorname	prénom
vorgänger	prédécesseur
hitler	hitler
angst	angoisse
autonome	autonome
dimensionen	dimensions
revolution	révolution
nächste	prochaine
komponist	compositeur
pfarrer	curé
mainz	mayence
mundstück	embouchure
klosters	cloîtres
farben	couleurs
alan	alan
dänisch	danois
mosel	moselle
geburt	naissance
foto	photo
ideen	idées
repräsentation	représentation
zwei	deux
angreifen	attaquer
texas	texas
logik	logique
diplomat	diplomate
phänomen	phénomène
mühlen	moulins
particulier	particulier
gedanke	pensée
jugend	jeunesse
amerika	amérique
privat	privé
gilbert	gilbert
entdecken	découvrir
werkzeug	outil
offizier	officier
halten	tenir
truppen	troupes
basque	basque
datiert	daté
börse	bourse
augsburg	augsbourg
diese	diese
einfach	simple
normandie	normandie
jerry	jerry
anzeigen	indiquer
joseph	joseph
bulgarien	bulgarie
interne	interne
schreiber	écrivain
könig	roi
trophäe	trophée
jetzt	maintenant
polonaise	polonaise
anschaffung	acquisition
pavillon	pavillon
tunnel	tunnel
synagoge	synagogue
xavier	xavier
verlassen	abandonné
dach	toit
dreizehn	treize
göttingen	göttingen
metz	metz
dialog	dialogue
kommen	venir
freiburg	fribourg
gross	gros
azur	azur
silber	argent
anomalie	anomalie
kaufmann	commerçant
verurteilt	condamné
halt	arrêt
html	html
modifiziert	modifié
rouge	rouge
russell	russell
behandeln	traiter
heiligtum	sanctuaire
york	york
ryan	ryan
redakteur	rédacteur
dame	dame
minister	ministre
benutzen	utiliser
mutter	mère
romaine	romaine
bamberg	bamberg
möglichkeit	possibilité
dvd	dvd
navarre	navarre
kandidat	candidat
jährlich	annuellement
habt	avez
nominierung	nomination
pariser	parisien
irak	irak
glas	verre
platz	place
ausdehnung	étendue
julie	julie
türen	portes
spiegel	miroir
sizilien	sicile
entität	entité
integration	intégration
vancouver	vancouver
potsdam	potsdam
verbrauch	consommation
schnee	neige
keiner	aucun
kanadier	canadiens
stirbt	meurt
präsentation	présentation
geschäftsführer	gérant
fonds	fonds
konsul	consul
künstler	artiste
ursprung	origine
spuren	empreintes
endlich	enfin
schach	échecs
partei	parti
id	id
plattform	plateforme
abkürzung	abréviation
transport	transport
pilot	pilote
charaktere	caractères
britisch	britannique
beaucoup	beaucoup
fenster	fenêtre
landschaft	paysage
youtube	youtube
ziehen	tirer
wurzeln	racines
bourgogne	bourgogne
teilgenommen	participé
zog	zog
endgültig	définitif
midi	midi
institut	institut
marmor	marbre
telefon	téléphone
architekt	architecte
natur	nature
schlagen	battre
massachusetts	massachusetts
unternehmen	entreprendre
typisch	typique
türke	turc
renommee	renommée
ratschläge	conseils
details	détails
frauen	frauen
freund	ami
jeder	chacun
eure	eure
korrekt	correct
tourismus	tourisme
aktivität	activité
extrême	extrême
verantwortung	responsabilité
partizipation	participation
fünftes	cinquième
normal	normal
erwartet	attendu
mythologie	mythologie
ergebnisse	résultats
konservator	conservateur
nelson	nelson
pianist	pianiste
schiedsrichter	arbitre
christus	christus
atmosphäre	atmosphère
navigation	navigation
illinois	illinois
walther	walther
erfahrung	expérience
deponiert	déposé
struktur	structure
lateinisch	latin
unesco	unesco
finanzen	finances
literatur	litterature
entrée	entrée
ressourcen	ressources
wählen	choisir
ulrich	ulrich
dokumente	documents
spezialist	spécialiste
regionen	régions
versuchen	essayer
konkurrenz	concurrence
umbenennung	renommage
liga	ligue
flügel	aile
prise	prise
marie	marie
aktuell	actuel
geehrt	honoré
gehören	appartenir
frankfurt	francfort
geographisch	géographique
streik	grève
schmidt	schmidt
bringt	apporte
besuch	visite
repräsentieren	représenter
lanciert	lancé
konferenz	conférence
xls	xls
familien	familles
unbedingt	impérativement
viertel	quartier
darmstadt	darmstadt
idee	idée
variabel	variable
wilaya	wilaya
winter	hiver
sekundarstufe	secondaire
ouvertüre	ouverture
volumen	volume
etüde	étude
beitrag	beitrag
verlängert	allongé
noms	noms
favor	faveur
eva	éva
gürtel	ceinture
senden	envoyer
dorf	village
motor	moteur
zentimeter	centimètre
führerschein	permis
regeln	régler
übung	exercice
oberliga	oberliga
gesicht	visage
eingeweiht	initié
analyse	analyse
zeichen	signe
gewinnen	gagner
entdeckung	découverte
gehörte	appartenait
imho	imho
gesang	chant
animator	animateur
boulogne	boulogne
getragen	porté
einkauf	achat
raoul	raoul
bestandteil	composant
priorei	prieuré
historiker	historien
dotiert	doté
gebraucht	usagé
serbien	serbie
konferenzen	conférences
antoine	antoine
barcelona	barcelone
koreanisch	coréen
gustave	gustave
akademie	académie
internationale	internationale
hafen	port
frühling	printemps
korrespondenz	correspondance
entfernen	éloigner
geschwindigkeit	vitesse
christoph	christoph
kanada	canada
armand	armand
baum	arbre
tausend	mille
washington	washington
wittenberg	wittemberg
zusammenfluss	confluence
humor	humour
konstrukteur	constructeur
biologie	biologie
farbe	couleur
ausreichend	suffisant
abgelehnt	refusé
total	total
konzentration	concentration
lebendig	vivant
bedeutung	signification
voie	voie
schaden	dommage
