schlug	colpì
kolumbien	colombia
px	px
olympisch	olimpico
erinnerungen	ricordi
poesie	poesia
quellen	sorgenti
bereich	settore
dresden	dresda
dresdner	dresdner
jimmy	jimmy
durchgang	passaggio
grafschaft	contea
phasen	fasi
mechanismus	meccanismo
projekt	progetto
leiden	soffrire
kpd	kpd
verantwortung	responsabilità
gaetano	gaetano
wiederholt	ripetuto
arrest	arresto
winter	inverno
luciano	luciano
roboter	robot
effekte	effetti
gestalt	gestalt
wesentlich	essenziale
lehrte	insegnò
gärten	giardini
ressourcen	risorse
bd	bd
washington	washington
macht	potere
juden	ebrei
leidenschaft	passione
lesen	leggere
möglicherweise	possibilmente
informatik	informatica
abendmahl	cena
extrakt	estratto
normalerweise	normalmente
fern	lontano
inspiration	ispirazione
festung	fortezza
ausgeschlossen	escluso
orientalisch	orientale
schatz	tesoro
religiös	religioso
hartmann	hartmann
göttin	dea
renato	renato
öl	olio
bewegungen	movimenti
breslau	breslavia
enrico	enrico
wissenschaftlich	scientifico
ministerium	ministero
fünfzig	cinquanta
fußballer	calciatore
dame	dama
absolut	assoluto
pine	pino
risiko	rischio
sphäre	sfera
elf	elfo
fragmente	frammenti
ring	anello
kleine	piccola
radfahrer	ciclista
willy	willy
grundsätzlich	fondamentalmente
präsenz	presenza
einiger	einiger
ferroviario	ferroviario
hauptstadt	capitale
reisen	viaggiare
manier	maniera
auflösung	dissoluzione
tugend	virtù
laura	laura
gewinnt	vince
realisierte	realizzò
identität	identità
präsentiert	presentato
eventuell	eventualmente
baseball	baseball
nämlich	cioè
dvd	dvd
vorpommern	vorpommern
minuten	minuti
kanäle	canali
oberliga	oberliga
prozesse	processi
verbindungen	connessioni
gemeinschaft	comunità
laboratorium	laboratorio
masse	massa
gewünscht	desiderato
krankheiten	malattie
sydney	sydney
verse	versi
kollegen	colleghi
portal	portale
fulda	fulda
speziell	speciale
blatt	foglia
tourismus	turismo
mangel	mancanza
indianer	indiano
ob	ob
gesellschaft	società
sterne	stelle
stein	pietra
begabt	dotato
ländlich	rurale
mercedes	mercedes
paläste	palazzi
süd	sud
um	um
herbst	autunno
gebrauch	uso
ingenieurwesen	ingegneria
bildhauer	scultore
fluss	fiume
türkisch	turco
grafen	grafene
schiedsrichter	arbitro
sopra	sopra
expedition	spedizione
valign	valign
volkszählung	censimento
vs	vs
beitrag	contributo
sequenz	sequenza
flüsse	fiumi
bruder	fratello
josé	josé
schild	scudo
bürgermeister	sindaco
diejenigen	quei
karl	carlo
sichtbar	visibile
ausgang	uscita
schöpfung	creazione
messina	messina
handel	commercio
schwarz	nero
patriarch	patriarca
hms	hms
preise	prezzi
synchronsprecher	doppiatore
enzyklopädisch	enciclopedico
indien	india
ball	pallone
zähne	denti
spricht	parla
strukturen	strutture
miami	miami
andere	altra
bochum	bochum
adolf	adolfo
css	css
cagliari	cagliari
adler	aquila
explosion	esplosione
erzdiözese	arcidiocesi
füße	piedi
senza	senza
männer	uomini
botanischer	botanico
pflanzen	piantare
ersetzen	sostituire
tiere	animali
flotte	flotta
christina	cristina
beschreiben	descrivere
urteil	giudizio
aktiv	attivo
brunnen	fontana
camillo	camillo
philosopher	filosofo
sowjetisch	sovietico
elektronik	elettronica
landwirtschaft	agricoltura
nordwestlich	nordoccidentale
typisch	tipico
missionen	missioni
verbindung	connessione
beobachtung	osservazione
verbot	divieto
parteien	partiti
wiederaufbau	ricostruzione
gekommen	venuto
gleich	uguale
bibliothek	biblioteca
enzo	enzo
materialien	materiali
kandidatur	candidatura
inseln	isole
zuschauer	spettatore
firma	firma
traditionell	tradizionale
prototyp	prototipo
holstein	holstein
pop	pop
hätte	avrebbe
kanton	cantone
königlich	reale
selten	raro
waffe	arma
variationen	variazioni
blume	fiore
konzept	concetto
situation	situazione
demokratisch	democratico
fels	roccia
sinn	senso
architektur	architettura
lisa	lisa
singulär	singolare
erkennbar	riconoscibile
karte	mappa
murray	murray
finden	trovare
prozess	processo
erobern	conquistare
russland	russia
folgten	seguirono
geschlossen	chiuso
angriff	attacco
motoren	motori
york	york
südafrika	sudafrica
maschera	maschera
moore	moore
lizenz	licenza
simone	simone
eddie	eddie
capito	capito
kanone	cannone
brasilianer	brasiliano
zone	zona
schlüssel	chiave
donald	donald
erlaubnis	permesso
thema	tema
verloren	perduto
sostenuto	sostenuto
namen	nomi
allgemeine	allgemeine
elemente	elementi
mehr	più
moral	morale
verteidiger	difensore
spannung	tensione
initiative	iniziativa
gern	volentieri
teilen	condividere
unter	sotto
korea	corea
patriot	patriota
widerstand	resistenza
erzählung	racconto
belgien	belgio
katalog	catalogo
gattungen	generi
beide	entrambe
werte	valori
fragen	chiedere
drehbuchautor	sceneggiatore
regelung	regolazione
anlagen	impianti
erinnerung	ricordo
geöffnet	aperto
siegte	vinse
operiert	operato
garten	giardino
persönlichkeit	personalità
autonomie	autonomia
google	google
funktionen	funzioni
weihnachten	natale
korrigiert	corretto
ereignis	avvenimento
nationen	nazioni
territorien	territori
wagner	wagner
franziskus	francesco
erfahrung	esperienza
periode	periodo
lorenzo	lorenzo
gross	grosso
soli	soli
süß	dolce
abwesenheit	assenza
verluste	perdite
besucht	visitato
dfb	dfb
nein	no
prüfung	prova
diana	diana
russo	russo
ausgebildet	istruito
michigan	michigan
fusion	fusione
settimo	settimo
georgia	georgia
atto	atto
frei	libero
stadion	stadio
geschrieben	scritto
italo	italo
grazia	grazia
nba	nba
variante	variante
bauen	costruire
morgan	morgan
schläge	colpi
forti	forti
franzosen	francesi
novara	novara
priester	prete
verstehen	capire
schriftstellerin	scrittrice
inzwischen	intanto
williams	williams
freiburg	friburgo
chemie	chimica
automatik	automatico
institut	istituto
kollegium	collegio
saal	sala
garibaldi	garibaldi
videospiel	videogioco
autor	autore
farbe	colore
genug	abbastanza
samstag	sabato
türkei	turchia
ukraine	ucraina
php	php
russell	russell
amerikaner	americano
adam	adamo
dokument	documento
verfassung	costituzione
armando	armando
persönlich	personale
phänomene	fenomeni
licht	luce
studieren	studiare
flora	flora
wiederaufnahme	ripresa
beobachten	osservare
emilio	emilio
weltrekord	record
meinungen	opinioni
\cdot	\cdot
schreiben	scrivere
beweisen	dimostrare
bevölkerung	popolazione
verona	verona
manchmal	talvolta
sache	cosa
adresse	indirizzo
schnitt	taglio
scott	scott
europäisch	europeo
stimmen	stimmen
kanal	canale
coi	coi
jonathan	jonathan
sektoren	settori
orientierung	orientamento
langsam	lentamente
turm	torre
fleisch	carne
wache	guardia
partisan	partigiano
beschädigt	danneggiato
tanz	danza
paris	parigi
plattform	piattaforma
dampf	vapore
chemiker	chimico
toronto	toronto
extremität	estremità
zehn	dieci
vorderer	anteriore
ryan	ryan
finnisch	finlandese
magie	magia
endgültig	definitivo
besaß	possedeva
sekretär	segretario
professionell	professionale
verbrechen	reato
eingetragen	iscritto
hören	ascoltare
kurzfilm	cortometraggio
zeichnungen	disegni
anspruch	pretesa
bischof	vescovo
linz	linz
vorteil	vantaggio
offensive	offensiva
software	software
tasso	tasso
malta	malta
natur	natura
anfang	inizio
kassel	kassel
ehre	onore
wittenberg	wittenberg
millionen	milioni
chronik	cronaca
abstammung	discendenza
bearbeitungen	lavorazioni
hollywood	hollywood
polo	polo
stücke	pezzi
signalisierung	segnalazione
japanisch	giapponese
kommunistisch	comunista
episoden	episodi
niederlage	sconfitta
stahl	acciaio
signale	segnali
>	>
eigentum	proprietà
geteilt	diviso
organisierung	organizzazione
serra	serra
jahre	anni
heidelberg	heidelberg
haus	casa
lothar	lothar
oft	spesso
westlich	occidentale
druck	pressione
barock	barocco
schwert	spada
mitglieder	membri
silber	argento
flugzeug	aeroplano
lee	lee
französisch	francese
griechisch	greco
reinhard	reinhard
eindruck	impressione
bbc	bbc
tief	profondo
arthur	arthur
alle	tutti
entspricht	corrisponde
ergebnis	risultato
ausnahme	eccezione
atp	atp
ursprung	origine
katharina	caterina
operationen	operazioni
einleitung	introduzione
bericht	rapporto
solist	solista
ok	ok
klassifizierung	classificazione
leistungen	prestazioni
zweifel	dubbio
dimensionen	dimensioni
eliminiert	eliminato
formuliert	formulato
staatliche	statale
wörterbuch	dizionario
spielen	giocare
gerufen	chiamato
geheimnis	segreto
nachricht	notizia
warum	perchè
prozedur	procedura
becken	bacino
marathon	maratona
sed	sed
frankfurter	frankfurter
begegnung	incontro
gebiete	gebiete
regionale	regionale
kommentar	commento
accompagnato	accompagnato
hd	hd
nürnberg	norimberga
harald	harald
hölle	inferno
nrw	nrw
einverständnis	consenso
nation	nazione
völker	popoli
beziehungen	beziehungen
interview	intervista
etwas	qualcosa
abgelaufen	scaduto
güter	beni
diplomatisch	diplomatico
prozentsatz	percentuale
garantieren	garantire
jede	ognuna
orte	luoghi
augustin	agostino
overs	overs
alexander	alessandro
region	regione
draußen	fuori
typ	tipo
ehemann	marito
krieg	guerra
tomba	tomba
erinnert	ricorda
arrondissement	arrondissement
dänemark	danimarca
spanisch	spagnolo
bobby	bobby
mauer	muro
heraldik	araldica
überflüssig	superfluo
gianni	gianni
bedrohung	minaccia
villen	ville
spieler	giocatore
erscheinung	apparizione
ulrich	ulrico
vögel	uccelli
schlacht	battaglia
grau	grigio
paderborn	paderborn
würzburg	würzburg
hitler	hitler
illinois	illinois
oblast	oblast
throne	trono
mittelalterlich	medievale
wuppertal	wuppertal
bulgarien	bulgaria
zufällig	casuale
tempo	tempo
ferdinand	ferdinando
hart	duro
bauten	costruzioni
sänger	cantore
wählen	scegliere
raccolta	raccolta
sponsor	sponsor
walter	walter
aufbau	aufbau
positiv	positivo
leicht	leggero
youtube	youtube
assoziiert	associato
kaufte	acquistò
schatten	ombra
titel	titolo
dauer	durata
lokalisierung	localizzazione
temperatur	temperatura
name	nome
hoffnung	speranza
lloyd	lloyd
polnisch	polacco
eis	ghiaccio
direkt	direttamente
gino	gino
sein	essere
liegen	giacere
wollen	volere
bartolomeo	bartolomeo
tenor	tenore
unterart	sottospecie
howard	howard
koblenz	coblenza
maurizio	maurizio
instrumente	strumenti
clan	clan
magdeburg	magdeburgo
musik	musica
gesang	canto
vietnam	vietnam
veste	veste
fabrizio	fabrizio
konzeption	concezione
paar	coppia
wm	wm
drama	dramma
batterie	batteria
todd	todd
interpretiert	interpretato
vorschlag	proposta
offensichtlich	ovvio
ungarisch	ungherese
physik	fisica
wärme	calore
sino	sino
zentrum	centro
nordrhein	nordrhein
griff	grifo
bambino	bambino
woche	settimana
frühling	primavera
wunsch	desiderio
bronze	bronzo
november	novembre
lg	lg
friedhof	cimitero
norwegisch	norvegese
aosta	aosta
abkürzung	abbreviazione
unternehmungen	imprese
autorität	autorità
england	inghilterra
jungs	ragazzi
religion	religione
denomination	denominazione
heilig	sacro
diskussionen	discussioni
objekt	oggetto
spät	tardi
geschichte	storia
verdacht	sospetto
anonymus	anonimo
logo	logotipo
lp	lp
arnold	arnoldo
vatikan	vaticano
brüssel	bruxelles
giro	giro
überall	dappertutto
verteidigung	difesa
reduktion	riduzione
vorschläge	proposte
jh	jh
prinzip	principio
orchester	orchestra
raffaele	raffaele
zement	cemento
schweden	svedesi
eingefügt	inserito
kult	culto
gezeigt	mostrato
termine	termine
paragraf	paragrafo
eishockey	hockey
in	in
territorium	territorium
abteilungen	reparti
punkt	punto
baureihe	baureihe
errichten	erigere
bezirke	distretti
siena	siena
geschäfte	affari
stark	stark
markenzeichen	marchio
polonaise	polacca
entwickeln	sviluppare
artikel	articolo
zeitschrift	rivista
geschwindigkeit	velocità
sachsen	sassonia
repräsentant	rappresentante
blöcke	blocchi
stephanus	stefano
philadelphia	filadelfia
videospiele	videogiochi
erfolg	successo
qualifikation	qualificazione
drittes	terzo
jugoslawien	jugoslavia
hand	mano
säule	colonna
disposition	disposizione
neutral	neutrale
gesegnet	benedetto
klasse	classe
oberfläche	superficie
•	•
lesung	lettura
abo	abo
technologie	tecnologia
realisierung	realizzazione
walther	walther
konfrontation	confronto
konstantin	costantino
org/w/index	org/w/index
passagen	passaggi
kurve	curva
format	formato
kavallerie	cavalleria
gruppen	gruppi
indica	indica
matrize	matrice
frucht	frutto
verlängert	prolungato
berlin	berlino
dm	dm
helden	eroi
wann	quando
baum	albero
nehmen	prendere
feuer	fuoco
nationalsozialismus	nazionalsocialismo
remix	remix
schwierigkeit	difficoltà
referenzen	riferimenti
bundesliga	bundesliga
stockholm	stoccolma
mühe	fatica
giulia	giulia
phantastik	fantascienza
filmografie	filmografia
bedingung	condizione
atmosphäre	atmosfera
stil	stile
pflanze	pianta
dauerte	durò
eva	eva
diözese	diocesi
architekten	architetti
kooperation	cooperazione
homonym	omonimo
interessant	interessante
öffnung	apertura
png	png
editorial	editoriale
disziplin	disciplina
germania	germania
dokumentarfilm	documentario
giovanni	giovanni
aviso	avviso
gold	oro
klima	clima
entwickelt	sviluppato
beschreibung	descrizione
bearbeitet	bearbeitet
asien	asia
magazin	magazzino
geld	denaro
führen	guidare
charakter	carattere
schottisch	scozzese
sizilien	sicilia
organisiert	organizzato
angriffe	attacchi
verlust	perdita
orgel	organo
stanley	stanley
verdienst	merito
manifestation	manifestazione
existierend	esistente
befreiung	liberazione
olympiade	olimpiade
einladung	invito
laterale	laterale
schwester	sorella
luxemburg	lussemburgo
wort	parola
prinzipien	principi
motor	motore
weimar	weimar
fahrzeug	veicolo
schon	già
zudem	inoltre
termini	termini
bauern	contadini
schnee	neve
habsburg	asburgo
zuviel	troppo
unternehmung	impresa
familie	famiglia
förderung	promozione
circa	circa
navale	navale
frequenz	frequenza
✉	✉
konstantinopel	costantinopoli
bildung	formazione
kathedrale	cattedrale
du	du
barre	barra
überraschung	sorpresa
union	unione
geschmack	gusto
uhr	orologio
gezählt	conteggiato
zitiert	citato
hilfe	aiuto
nella	nella
gut	buono
trikot	maglia
filo	filo
trainer	allenatore
jurist	giurista
louis	louis
stafette	staffetta
mobile	mobile
meinung	opinione
verblieb	rimase
truppen	truppe
verzeichnis	verzeichnis
stadt	città
terrain	terreno
brescia	brescia
exzellenz	eccellenza
integriert	integrato
saarbrücken	saarbrücken
gemeinden	comuni
österreichisch	austriaco
byzantinisch	bizantino
rimini	rimini
gewinnen	vincere
einfach	semplice
kommandant	comandante
abend	serata
weiblich	femminile
verdienste	meriti
menschlich	umano
februar	febbraio
mtv	mtv
registriert	registrato
künstlich	artificiale
decreto	decreto
beispiele	esempi
konsequenzen	conseguenze
fisch	pesce
kastilien	castiglia
felder	campi
franziska	francesca
nukleus	nucleo
vandalismus	vandalismo
manifestationen	manifestazioni
metall	metallo
kapitel	capitolo
abschnitte	sezioni
bamberg	bamberga
akademie	accademia
traditionen	tradizioni
mehrheit	maggioranza
gemälde	dipinti
thomas	tommaso
hotel	albergo
gäste	ospiti
individuum	individuo
ansiedlung	insediamento
ingenieur	ingegnere
wikimedia	wikimedia
aspekte	aspetti
ausgewählt	scelto
erziehung	educazione
conti	conti
holland	olanda
ersatz	sostituto
note	nota
agent	agente
sehr	sehr
aldo	aldo
hannover	hannover
wettkampf	gara
manager	manager
fliehen	fuggire
ausgeführt	eseguito
österreich	austria
bewegung	movimento
fahne	bandiera
nennung	nomina
elektrisch	elettrico
permanente	permanente
ecke	angolo
dante	dante
apr	apr
boote	barche
xv	xv
internazionali	internazionali
federico	federico
internet	internet
neu	nuovo
bielefeld	bielefeld
monat	mese
hamilton	hamilton
zwei	due
kam	kam
beiträge	contributi
entscheidungen	decisioni
silvio	silvio
heiligtum	santuario
dave	dave
bedeutung	significato
spezies	specie
millimeter	millimetro
wachsen	crescere
gewinn	guadagno
bezirk	distretto
mathematik	matematica
wiesbaden	wiesbaden
generalleutnant	generale
ökonomie	economia
forschung	ricerca
imho	imho
nei	nei
gottfried	gottfried
wiki	wiki
umbenannt	rinominato
faktor	fattore
vorgeschlagen	proposto
gegenstände	oggetti
kunden	clienti
anweisung	istruzione
januar	gennaio
exil	esilio
sue	sue
öffnen	aprire
material	materiale
adriano	adriano
ja	sì
fließt	fluisce
regel	regola
gestern	ieri
nationalität	nazionalità
rugby	rugby
betreiber	gestore
riga	riga
praxis	prassi
ursprünglich	originariamente
netz	rete
privat	privato
menschlichkeit	umanità
unser	nostro
friedrich	friedrich
dortmund	dortmund
mutter	mamma
exzentrizität	eccentricità
uniti	uniti
übrig	rimanente
woiwodschaft	voivodato
trio	trio
politik	politica
vizepräsident	vicepresidente
fliegen	volare
sonora	sonora
geändert	cambiato
padua	padova
ausgrabungen	scavi
lancia	lancia
betrug	truffa
vladimir	vladimir
bischöfliche	vescovile
renzo	renzo
münze	moneta
dramaturg	drammaturgo
ravenna	ravenna
theologe	teologo
kaiser	imperatore
bleiben	rimanere
modifiziert	modificato
königreich	regno
kilometer	chilometro
neumann	neumann
strand	spiaggia
giacomo	giacomo
mord	omicidio
sechst	sesto
mindestens	almeno
christus	cristo
september	settembre
volk	popolo
hc	hc
verteilung	distribuzione
philosophie	filosofia
marburg	marburgo
fenster	finestra
anrufung	chiamata
wahr	vero
claudio	claudio
denkmal	monumento
strahl	raggio
alex	alex
krankenhaus	ospedale
invasion	invasione
gamma	gamma
flanke	fianco
forschungen	ricerche
belagerung	assedio
blumen	fiori
harry	harry
fernsehen	fernsehen
volumen	volume
html	html
verlegerin	editrice
müsste	dovrebbe
orlando	orlando
experte	esperto
etikett	etichetta
generali	generali
pokémon	pokémon
regensburg	ratisbona
kombination	combinazione
markt	mercato
gewalttätigkeit	violenza
ereignisse	avvenimenti
afrika	afrika
anna	anna
salzburg	salisburgo
luigi	luigi
flugzeuge	aeroplani
lazio	lazio
qualifiziert	qualificato
pommern	pomerania
bassist	bassista
spazio	spazio
kontakte	contatti
motivationen	motivazioni
fortsetzung	continuazione
übersetzung	traduzione
jena	jena
davis	davis
kraft	kraft
zentrale	centrale
lösen	sciogliere
bass	basso
gras	erba
konzert	concerto
anthony	anthony
beschränkt	limitato
filmen	filmare
verstärkt	rafforzato
fernando	fernando
rache	vendetta
gitarrist	chitarrista
kleinstadt	cittadina
töten	uccidere
voraussetzungen	presupposti
eugen	eugenio
erfolge	successi
kirche	chiesa
bank	banca
polizei	polizia
gemacht	fatto
neun	nove
lombardei	lombardia
italienisch	italiano
verkaufen	vendere
höhe	altezza
ich	io
wein	vino
typologie	tipologia
motivation	motivazione
rennstrecke	circuito
anfrage	richiesta
heer	esercito
dialog	dialogo
umwandlung	trasformazione
produzenten	produttori
biologie	biologia
geeignet	adatto
anime	anime
vogel	uccello
konzil	concilio
übung	esercizio
bundeswehr	bundeswehr
angekommen	arrivato
total	totale
verschoben	spostato
gerecht	giusto
gefärbt	colorato
antworten	rispondere
debütierte	debuttò
beobachtet	osservato
sohn	figlio
presbyter	presbitero
rudolf	rudolf
missbrauch	abuso
udine	udine
krankheit	malattia
dienen	servire
befördert	promosso
entwurf	disegno
krone	corona
synonym	sinonimo
verband	associazione
gustav	gustav
eberhard	eberhard
nordamerika	nordamerica
ferrari	ferrari
entschuldigung	scusa
zugehörigkeit	appartenenza
squadra	squadra
giuseppe	giuseppe
welle	onda
unendlich	infinito
ausstellung	esposizione
jährlich	annuale
arm	braccio
nordosten	nordest
minute	minuto
jackson	jackson
moritz	moritz
werden	divenire
hanau	hanau
wolf	lupo
kroatien	croazia
hinzufügen	aggiungere
ausgehen	uscire
lösung	soluzione
pedro	pedro
theologie	teologia
sieht	vede
nominiert	nominato
bewaffnet	armato
ozean	oceano
"	"
deutsch	tedesco
mb	mb
gehabt	avuto
alpen	alpi
operativ	operativo
michele	michele
launch	lancio
wahrscheinlichkeit	probabilità
peru	perù
a	a
dynastie	dinastia
schwestern	sorelle
effekt	effetto
thailand	thailand
verkehr	traffico
pistole	pistola
cousin	cugino
dunkel	scuro
dichte	densità
ausführung	esecuzione
mary	mary
toskana	toscana
enge	stretta
sechste	sesta
maler	pittore
kommentare	commenti
pilot	pilota
linien	linee
pavia	pavia
konsequenz	conseguenza
ausdehnung	estensione
fussball	calcio
carolina	carolina
botschaft	ambasciata
stuttgart	stuttgart
piemont	piemonte
audio	audio
sturm	tempesta
neapel	napoli
ruhe	riposo
ständig	costantemente
modalität	modalità
verfügbar	disponibile
auch	anche
maschine	macchina
brigade	brigata
senator	senatore
umgekehrt	rovesciato
erwähnt	menzionato
kiel	kiel
km/h	km/h
infrastruktur	infrastruttura
kommunikation	comunicazione
techniken	tecniche
april	aprile
andrew	andrew
niccolò	niccolò
konflikt	conflitto
aktion	azione
verdient	meritato
norwegen	norvegia
wenig	poco
jones	jones
gesprochen	pronunciato
vereinigt	unito
himmel	cielo
verantwortlich	responsabile
leben	vivere
museen	musei
sara	sara
erzbischof	arcivescovo
enzyklopädie	enciclopedia
svg	svg
parks	parchi
besuch	visita
geographie	geografia
romagna	romagna
beigetragen	contribuito
alfonso	alfonso
clubnat	clubnat
artillerie	artiglieria
tokyo	tokyo
versuche	tentativi
jagd	caccia
online	online
sammeln	raccogliere
grüße	saluti
kollaboration	collaborazione
zitat	citazione
genie	genio
veröffentlichungen	pubblicazioni
kantate	cantata
playstation	playstation
anwendungen	applicazioni
schützen	proteggere
mythos	mito
graf	graf
gerhard	gerhard
wissenschaft	scienza
erreicht	raggiunto
erkenntnis	conoscenza
wilson	wilson
bauer	contadino
partei	partito
diskutieren	discutere
modena	modena
bewertung	valutazione
antonio	antonio
oldenburg	oldenburgo
landtag	landtag
buchstaben	lettere
nützlich	utile
redaktion	redazione
festschrift	festschrift
gewissen	coscienza
literatur	letteratura
konserviert	conservato
lübeck	lubecca
geschehen	accaduto
neffe	nipote
übersetzt	tradotto
anerkennung	riconoscimento
bibliografie	bibliografia
kontrast	contrasto
virginia	virginia
marcello	marcello
bundestag	bundestag
fliege	mosca
regime	regime
mann	uomo
mario	mario
chinesisch	cinese
miguel	miguel
beobachtungen	osservazioni
ginevra	ginevra
jury	giuria
schwach	debole
gräfin	contessa
produkt	prodotto
freund	amico
duo	duo
erfinder	inventore
hahn	gallo
trophäe	trofeo
decoration	decorazione
falsche	falsa
notwendigkeit	necessità
tennisspieler	tennista
andrea	andrea
revision	revisione
sonntag	domenica
acht	otto
mecklenburg	meclemburgo
schriften	scritture
singles	singoli
\frac	\frac
nassau	nassau
gerechtigkeit	giustizia
bryan	bryan
service	servizio
ägypten	egitto
körper	corpo
inhalte	contenuti
pianist	pianista
glaube	fede
einzel	singolo
text	testo
bedingungen	condizioni
kontrolle	controllo
parlamentarier	parlamentare
spezialität	specialità
tirol	tirolo
nuovi	nuovi
legende	leggenda
kindheit	infanzia
preußen	prussia
@	@
mythologie	mitologia
bett	letto
versteckt	nascosto
marino	marino
der	il
arbeiten	lavorare
bahnhof	stazione
landschaft	paesaggio
gebraucht	usato
rizzoli	rizzoli
dienste	servizi
heinz	heinz
falsch	falso
kostüme	costumi
vater	padre
nutzung	utilizzo
fahrzeuge	veicoli
abenteuer	avventura
möglich	possibile
wiese	prato
besetzt	occupato
dieser	questo
skulptur	scultura
fusse	fuso
sci	sci
fifa	fifa
halbinsel	penisola
serbisch	serbo
zeitschriften	riviste
gruppe	gruppo
dura	dura
natürlich	naturale
madonna	madonna
pennsylvania	pennsylvania
besitzt	possiede
dissertation	tesi
evangelisch	evangelico
autobahn	autostrada
erde	terra
überprüfung	verifica
?	?
sammlungen	raccolte
giuliano	giuliano
sämtliche	sämtliche
blätter	foglie
gt	gt
viva	viva
folgen	seguire
chor	coro
tribunal	tribunale
aragona	aragona
kritik	critica
fakultät	facoltà
schwedisch	svedese
chronologie	cronologia
archivierung	archiviazione
deckung	copertura
bob	bob
porträt	ritratto
senat	senato
vertrauen	fiducia
medaille	medaglia
ersetzt	sostituito
dokumentation	documentazione
konvention	convenzione
provinz	provincia
hg	hg
kontext	contesto
schließung	chiusura
navigation	navigazione
pferd	cavallo
hildesheim	hildesheim
jahreszeiten	stagioni
durchmesser	diametro
champion	campione
sito	sito
schritte	passi
programmierung	programmazione
basa	basa
steiermark	stiria
rossi	rossi
allein	solo
details	dettagli
kulturell	culturale
slowakei	slovacchia
signalisieren	segnalare
geworden	divenuto
erwähnung	menzione
rasse	razza
zeichen	segno
repräsentanten	rappresentanti
könnte	potrebbe
sechzig	sessanta
lektionen	lezioni
übersetzer	traduttore
jeder	ognuno
böhmen	boemia
fischer	pescatore
wahlen	elezioni
bearbeitung	lavorazione
tausend	mille
treviso	treviso
diskussion	discussione
salto	salto
salvatore	salvatore
günter	günter
zugeteilt	assegnato
besonderheit	particolarità
standard	standard
august	augusto
industrie	industria
wollte	voleva
verpflichtet	obbligato
zurückgezogen	ritirato
alt	antico
kosten	costi
bist	bist
schema	schema
disney	disney
witwe	vedova
suchen	cercare
abtei	abbazia
differenz	differenza
motiv	motivo
gitarre	chitarra
redakteur	redattore
trotzdem	nonostante
wiederhergestellt	ripristinato
neuheit	novità
münzen	monete
wild	selvatico
division	divisione
beteiligung	coinvolgimento
schulen	scuole
abschnitt	sezione
rücken	schiena
emanuel	emanuele
norma	norma
geist	spirito
mund	bocca
jpg	jpg
synagoge	sinagoga
bretagne	bretagna
augen	occhi
ausdruck	espressione
caesar	cesare
johnson	johnson
legato	legato
residenten	residenti
jung	giovane
weiß	bianco
pdf	pdf
wdr	wdr
göttingen	gottinga
infobox	infobox
information	informazione
eisenbahnen	ferrovie
potsdam	potsdam
antwort	risposta
fuß	piede
perse	perse
aktuell	attuale
komödie	commedia
kolonie	colonia
eingetreten	entrato
harris	harris
folgt	segue
experimentell	sperimentale
barcelona	barcellona
kärnten	carinzia
welt	mondo
restaurierung	restauro
dokumente	documenti
berühmt	famoso
brüder	fratelli
lewis	lewis
umberto	umberto
caso	caso
tageszeitung	giornale
geschieht	avviene
ändern	cambiare
verfolgung	persecuzione
komisch	comico
veränderungen	cambiamenti
büro	ufficio
szene	scena
indoor	indoor
ideen	idee
angekündigt	annunciato
geburt	nascita
blockiert	bloccato
potenza	potenza
terry	terry
erreichbar	raggiungibile
anderson	anderson
stiftung	fondazione
wichtig	importante
christentum	cristianesimo
verwaltung	amministrazione
schneller	schneller
erlebnisse	esperienze
universität	università
bestimmt	determinato
colspan	colspan
faschismus	fascismo
gesucht	cercato
asti	asti
eltern	genitori
zdf	zdf
broadway	broadway
eigentümer	proprietario
grippe	influenza
glockenturm	campanile
aufmerksamkeit	attenzione
sicher	sicuro
opfer	sacrificio
basketball	pallacanestro
asteroid	asteroide
rücksicht	riguardo
existenz	esistenza
museum	museo
serie	serie
kompagnie	compagnia
altertümer	antichità
kennt	conosce
oskar	oscar
maximum	massimo
sergio	sergio
iran	iran
fehlt	manca
dimension	dimensione
buch	libro
umbenennung	rinominazione
beruf	professione
übergeben	consegnare
blut	sangue
regulär	regolare
lehrstuhl	cattedra
frauen	donne
danke	grazie
gesetze	leggi
partner	partner
tübingen	tübingen
grenze	confine
erfurt	erfurt
kampf	lotta
krater	cratere
staat	stato
sprint	sprint
milliarden	miliardi
index	indice
salerno	salerno
experten	esperti
situationen	situazioni
komponenten	componenti
sofia	sofia
tommy	tommy
frankreich	francia
kuppel	cupola
mächtig	potente
evolution	evoluzione
geschätzt	apprezzato
haben	avere
halten	tenere
konzession	concessione
dachte	pensava
allgemeinen	allgemeinen
sanremo	sanremo
kanonen	cannoni
interventionen	interventi
schwer	pesante
abbildung	raffigurazione
nachname	cognome
punk	punk
hunderte	centinaia
einfluss	influsso
synthese	sintesi
rangliste	classifica
ciao	ciao
plötzlich	improvvisamente
gefahren	pericoli
feuersbrunst	incendio
gigant	gigante
lemma	lemma
karlsruhe	karlsruhe
rückkehr	ritorno
kompagnon	compagno
zusammensetzung	composizione
nürnberger	nürnberger
universo	universo
praktisch	pratico
geführt	guidato
entdeckung	scoperta
videoclip	videoclip
million	milione
zunahme	aumento
maß	misura
eier	uova
see	lago
~	~
mexiko	messico
verletzt	offeso
jemand	qualcuno
heilbronn	heilbronn
david	davide
linux	linux
organisationen	organizzazioni
eintragung	iscrizione
präzision	precisione
negativ	negativo
präsident	presidente
edits	edits
herz	cuore
augsburg	augsburg
form	forma
führer	führer
fotografie	fotografia
vorbereitung	preparazione
nichts	niente
formen	formare
guido	guido
neunzig	novanta
cdu	cdu
mönche	monaci
kongregation	congregazione
triest	trieste
geregelt	regolato
turin	torino
lorena	lorena
milanese	milanese
anderes	altro
finlandia	finlandia
königin	regina
klub	club
kalender	calendario
legion	legione
marmor	marmo
margherita	margherita
fdp	fdp
häufig	frequente
differenzen	differenze
königsberg	königsberg
produktion	produzione
dichter	poeta
lungo	lungo
gelungen	riuscito
statistisch	statistico
panorama	panorama
abgeordneter	deputato
hügel	collina
stück	pezzo
fehler	errore
interpreten	interpreti
rocca	rocca
fällen	cadere
riccardo	riccardo
archiv	archivio
wollten	volevano
rostock	rostock
ettore	ettore
teresa	teresa
beschuldigt	accusato
california	california
nicht	non
pläne	piani
ordnung	ordine
halbkugel	emisfero
scheinen	sembrare
☎	☎
säure	acido
ehrlich	onesto
alfa	alfa
idee	idea
freitag	venerdì
internationale	internazionale
journalist	giornalista
erscheinen	apparire
byte	byte
objektiv	obiettivo
dollar	dollaro
zyklus	ciclo
anfangen	iniziare
klinik	clinica
präsentation	presentazione
äquivalent	equivalente
hoffmann	hoffmann
töchter	figlie
glauben	credere
virus	virus
südamerika	sudamerica
reggio	reggio
arbeit	lavoro
mannheim	mannheim
komponist	compositore
krise	crisi
wiederherstellung	ripristino
argentinisch	argentino
moderni	moderni
philippinen	filippine
erzählungen	racconti
büros	uffici
jugend	gioventù
drei	tre
kriterium	criterio
schaden	danno
pasquale	pasquale
kopenhagen	copenaghen
entdecker	esploratore
stimme	voce
testament	testamento
friaul	friuli
komponente	componente
kongreß	congresso
teilnehmer	partecipante
dein	tuo
produzieren	produrre
giancarlo	giancarlo
antichi	antichi
pronto	pronto
tela	tela
schule	scuola
ecco	ecco
zeiten	zeiten
gelegenheit	occasione
domäne	dominio
rolf	rolfo
ducato	ducato
johnny	johnny
gedanken	pensieri
feind	nemico
beziehung	relazione
groß	grande
leer	vuoto
getroffen	colpito
diego	diego
matthäus	matteo
kennenlernen	conoscere
mittelfeldspieler	centrocampista
kapelle	cappella
alice	alice
energie	energia
punktzahl	punteggio
manchester	manchester
alfredo	alfredo
lecce	lecce
spuren	tracce
besonderer	besonderer
mandat	mandato
verschiebung	spostamento
erklären	spiegare
familiär	familiare
institutionen	istituzioni
marschall	maresciallo
anwendung	applicazione
schreiber	scrittore
bewerten	valutare
nur	nur
eroberung	conquista
arbeiter	lavoratore
datiert	datato
vision	visione
emma	emma
eintreten	entrare
durante	durante
durchbruch	sfondamento
schön	bello
cori	cori
texas	texas
fotograf	fotografo
gordon	gordon
dörfer	villaggi
industriell	industriale
daten	dati
wissenschaftler	scienziato
richter	giudice
·	·
mailand	milano
soldaten	soldati
wir	noi
tätigkeit	attività
monaco	monaco
vorwiegend	prevalentemente
traktat	trattato
miniserie	miniserie
partizipieren	partecipare
liga	lega
räder	ruote
israel	israele
einheit	unità
schlag	colpo
ausschliesslich	esclusivamente
minister	ministro
fossilien	fossili
°c	°c
quelle	sorgente
pakt	patto
eliminieren	eliminare
verteidigen	difendere
arriva	arriva
ausführen	eseguire
regisseur	regista
tage	giorni
akademisch	accademico
rapper	rapper
parlament	parlamento
analyse	analisi
verfolgt	inseguito
infanterie	fanteria
adelig	nobile
formulierung	formulazione
genre	genere
libretto	libretto
signal	segnale
flucht	fuga
taranto	taranto
geliebt	amato
martina	martina
kelly	kelly
drache	drago
philipp	filippo
komitee	comitato
qualität	qualità
spiele	giochi
endet	finisce
begraben	seppellito
vaterland	patria
formationen	formazioni
schlesien	slesia
freundschaft	amicizia
oratorium	oratorio
minima	minima
edoardo	edoardo
hände	mani
fertig	finito
verheiratet	sposato
realisieren	realizzare
sport	sport
ausstellungen	esposizioni
württemberg	württemberg
freunde	amici
historikerin	storica
russi	russi
moskau	moscovia
bekannt	conosciuto
geschlagen	sconfitto
unternehmer	imprenditore
wahrnehmung	percezione
nachrichten	notizie
gesehen	visto
historisch	storico
publikum	pubblico
sicherheit	sicurezza
indianerin	indiana
breve	breve
normen	norme
platin	platino
mathematiker	matematico
bergamo	bergamo
album	album
piste	pista
verhaftet	arrestato
qualifikationen	qualificazioni
korrespondent	corrispondente
nacht	notte
archäologie	archeologia
latina	latina
auflage	auflage
bataillon	battaglione
klang	suono
ralph	ralph
tradition	tradizione
wickets	wickets
erworben	acquisito
besser	meglio
geweiht	consacrato
minderjährig	minore
jahr	anno
konkurrenz	concorrenza
rosa	rosa
republik	repubblica
oktober	ottobre
iata	iata
stare	stare
alles	tutto
pfarrei	parrocchia
gefahr	pericolo
ab	ab
lyceum	liceo
baron	barone
er	er
abgelehnt	rifiutato
korrespondenz	corrispondenza
abteilung	reparto
volleyball	pallavolo
mussolini	mussolini
kabinett	gabinetto
basis	basis
sexuell	sessuale
fürst	principe
angestellter	impiegato
initiale	iniziale
animation	animazione
farben	colori
souveränen	sovrani
interesse	interesse
elena	elena
bild	immagine
portugal	portogallo
verhandlungen	trattative
geburtstag	compleanno
konföderation	confederazione
behandlung	trattamento
bibel	bibbia
akkord	accordo
lieder	canzoni
katze	gatto
endlich	infine
dorf	villaggio
konstanz	costanza
puglia	puglia
sia	sia
sprechen	parlare
informationen	informazioni
architekt	architetto
sportiv	sportivo
auge	occhio
verpflichtung	impegno
mariano	mariano
mexikaner	messicano
empfangen	ricevere
informiert	informato
warschau	varsavia
letzter	ultimo
eingang	ingresso
meer	mare
klassifiziert	classificato
soldat	soldato
heiratete	sposò
klassisch	classico
kommissar	commissario
tempel	tempio
duisburg	duisburg
pisa	pisa
über	über
akkorde	accordi
gas	gas
glücklich	felice
istanbul	istanbul
enorme	enorme
jazz	jazz
grundlegende	fondamentale
targa	targa
pfarrer	parroco
katholisch	cattolico
grundstücke	terreni
demokratie	democrazia
bernhard	bernardo
sterben	morire
freundin	amica
integration	integrazione
überprüfen	verificare
wert	valore
herbert	herbert
rückzug	ritirata
zweiter	secondo
veröffentlichung	pubblicazione
naja	naja
handbuch	manuale
stärke	forza
jesus	gesù
uefa	uefa
ohio	ohio
gelegentlich	occasionalmente
benutzen	utilizzare
donau	danubio
fünfte	quinta
sebastian	sebastiano
anpassung	adattamento
mitbegründer	cofondatore
paradies	paradiso
täler	valli
argument	argomento
physikalisch	fisico
allianz	alleanza
gewebe	tessuto
giorgio	giorgio
innsbruck	innsbruck
ddr	ddr
charaktere	caratteri
sarah	sarah
steine	pietre
besitzen	possedere
britannica	britannica
santiago	santiago
nationalsozialisten	nazionalsocialisti
achill	achille
beschrieben	descritto
wahrheit	verità
ankommen	arrivare
faschist	fascista
portion	porzione
tausch	scambio
unterscheiden	distingue
temporale	temporale
weimarer	weimarer
nhl	nhl
stellungen	posizioni
kapitän	capitano
nelson	nelson
sozialistisch	socialista
präfektur	prefettura
ecc	ecc
syndrom	sindrome
reduzieren	ridurre
koalition	coalizione
wissenschaften	scienze
herren	signori
aufstieg	aufstieg
→	→
leonardo	leonardo
aachen	aquisgrana
zweite	seconda
entdeckt	scoperto
register	registro
beenden	finire
marsch	marcia
gesundheit	salute
jahrzehnt	decennio
nord	nord
gewonnen	vinto
sardinien	sardegna
jerusalem	gerusalemme
albanisch	albanese
thüringen	turingia
nobilität	nobiltà
dänisch	danese
probleme	problemi
reform	riforma
sätze	frasi
vincenzo	vincenzo
pseudonym	pseudonimo
wörtlich	letteralmente
gefallenen	caduti
drehung	rotazione
vergleichbar	comparabile
gelöst	sciolto
generation	generazione
ursula	ursula
genau	esatto
martin	martino
blues	blues
hängen	impiccare
werbung	pubblicità
kämpfen	combattere
www	www
jetzt	adesso
roberto	roberto
brauerei	birrificio
rd	rd
mantua	mantova
zerstört	distrutto
entität	entità
unabhängigkeit	indipendenza
vormundschaft	tutela
blau	blu
fresko	affresco
gewidmet	dedicato
klavier	pianoforte
kalabrien	calabria
realisiert	realizzato
samuel	samuel
vai	vai
co	co
napoleon	napoleone
reaktion	reazione
unterstützung	sostegno
aka	aka
marco	marco
helfen	aiutare
zugang	accesso
metropolitana	metropolitana
budapest	budapest
ökonomisch	economico
laufen	correre
bmw	bmw
athleten	atleti
giulio	giulio
entworfen	progettato
super	super
savoyen	savoia
bewohnt	abitato
patient	paziente
amsterdam	amsterdam
jäger	cacciatore
griechenland	grecia
ruine	rovina
flügel	ala
gentile	gentile
gesagt	detto
eingeführt	introdotto
literarisch	letterario
liefert	fornisce
microsoft	microsoft
detektiv	detective
florida	florida
fabrik	fabbrica
künstlerisch	artistico
geschlecht	sesso
gesicht	faccia
warten	aspettare
hypothese	ipotesi
kritiker	critico
bord	bordo
onkel	zio
lateinisch	latino
luisa	luisa
tochter	figlia
gefängnis	carcere
soziologie	sociologia
kontrollieren	controllare
zugeschrieben	attribuito
horn	corno
verbreitung	diffusione
newton	newton
assistent	assistente
rivale	rivale
geheimnisse	segreti
rauch	fumo
darmstadt	darmstadt
subjekt	soggetto
repräsentation	rappresentazione
linear	linear
erdbeben	terremoto
osnabrück	osnabrück
verboten	vietato
interessiert	interessato
gleichzeitig	simultaneamente
wasser	acqua
irisch	irlandese
ferrovia	ferrovia
argumentation	argomentazione
und/oder	e/o
verlängerung	prolungamento
gießen	gettare
west	ovest
villa	villa
zivilisation	civiltà
turniere	tornei
dj	dj
notwendig	necessario
gianfranco	gianfranco
psychologie	psicologia
phänomen	fenomeno
ancona	ancona
ursache	causa
wikipedia	wikipedia
schottland	scozia
tanto	tanto
übertragung	trasmissione
größe	grandezza
schaufenster	vetrina
treu	fedele
maria	maria
ufer	riva
monika	monica
ita	ita
botswana	botswana
flughafen	aeroporto
umlaufbahn	orbita
boston	boston
gabriele	gabriele
feat	feat
mai	maggio
mba	mba
alessandria	alessandria
blick	sguardo
vittorio	vittorio
continuo	continuo
unbekannt	sconosciuto
wörter	parole
maschinen	macchine
münchner	münchner
ideal	ideale
wüste	deserto
biografie	biografia
migliore	migliore
entwickelung	sviluppo
künstler	artista
günther	günther
ton	tono
existiert	esiste
film	film
vermeiden	evitare
journalisten	giornalisti
politisch	politico
sto	sto
sla	sla
pferde	cavalli
episode	episodio
insekten	insetti
angst	angoscia
morgen	mattino
wisconsin	wisconsin
zukunft	futuro
trama	trama
quasi	quasi
stirbt	muore
opposition	opposizione
schaffen	creare
märz	marzo
residenz	residenza
regionen	regioni
passagiere	passeggeri
braun	bruno
#f	#f
argentinien	argentina
thermen	terme
feld	campo
gouverneur	governatore
rugbyspieler	rugbista
goethe	goethe
zustimmung	assenso
lombardisch	lombardo
seiten	pagine
jeff	jeff
methode	metodo
potenzial	potenziale
nulla	nulla
ekliptik	eclittica
zusammen	insieme
sprachen	lingue
söhne	figli
komponisten	compositori
sicherlich	sicuramente
angreifen	attaccare
kardinal	cardinale
löwen	leoni
niemand	nessuno
abt	abate
ep	ep
madrid	madrid
instrument	strumento
regiment	reggimento
zerstörung	distruzione
nächster	prossimo
mitteleuropa	mitteleuropa
zugänglich	accessibile
datum	dato
fuchs	volpe
kapazität	capacità
australier	australiano
kette	catena
zeremonie	cerimonia
hp	hp
mission	missione
identisch	identico
ron	ron
männlich	maschile
entfernen	rimuovere
verarbeitung	elaborazione
jüdisch	ebraico
stellung	posizione
anerkennungen	riconoscimenti
altar	altare
eins	uno
gegner	avversario
verurteilung	condanna
saison	stagione
knoten	nodo
moderna	moderna
nachbarn	vicini
siegerin	vincitrice
mühle	mulino
heiliger	santo
oper	opera
habitat	habitat
großvater	nonno
zürich	zurigo
aufgewachsen	cresciuto
staffel	squadriglia
erinnern	ricordare
engel	angelo
minimum	minimo
waffen	armi
franken	franken
verurteilt	condannato
herausforderung	sfida
geographica	geografica
erbschaft	eredità
konservierung	conservazione
schutz	protezione
clark	clark
vergangenheit	passato
denkmäler	monumenti
züge	treni
anton	anton
bücher	libri
schleswig	schleswig
materie	materia
doktor	dottore
basilika	basilica
stunde	ora
konto	conto
recht	diritto
kommerziell	commerciale
imperiale	imperiale
kopf	testa
video	video
souverän	sovrano
bolzano	bolzano
venedig	venezia
admiral	ammiraglio
akzeptieren	accettare
operation	operazione
statistik	statistica
parameter	parametro
ensemble	ensamble
london	londra
buenos	buenos
manga	manga
ausgaben	spese
seele	anima
substanz	sostanza
kommen	venire
begonnen	cominciato
liste	elenco
douglas	douglas
sola	sola
palast	palazzo
kurse	corsi
kollektion	collezione
modell	modello
bogen	arco
figur	figura
individuell	individuale
wachstum	crescita
viertel	quartiere
anker	ancora
ralf	ralf
produzent	produttore
ehefrau	moglie
europa	europa
ix	ix
»	»
registrierung	registrazione
inneres	interno
achtzig	ottanta
tipi	tipi
malerei	pittura
brücke	ponte
medizin	medicina
bürger	cittadino
dach	tetto
bedürfnis	bisogno
abgrenzung	delimitazione
liebe	amore
reise	viaggio
getrennt	separato
nördlich	settentrionale
zentimeter	centimetro
ankunft	arrivo
erklärung	spiegazione
glas	vetro
küste	costa
struktur	struttura
id	id
holz	legno
essen	mangiare
erster	primo
rechts	destra
fest	festa
reservat	riserva
angebot	offerta
mode	moda
roger	roger
stuart	stuart
fünf	cinque
hintergrund	sfondo
verbrauch	consumo
entstehung	entstehung
bonus	bonus
kontrakt	contratto
produkte	prodotti
glied	membro
fünftes	quinto
bande	banda
detail	dettaglio
gefunden	trovato
peking	pechino
wald	bosco
gast	ospite
rektor	rettore
intention	intenzione
radio	radio
schicksal	destino
schwierig	difficile
profil	profilo
zentren	centri
einzig	unico
einschlag	impatto
göttlichkeit	divinità
weib	femmina
kodex	codice
varietät	varietà
zerstören	distruggere
repräsentieren	rappresentare
herzog	duca
freiheit	libertà
beherbergen	ospitare
pari	pari
federation	federazione
schnell	schnell
lucca	lucca
bischöfe	vescovi
relevanz	rilevanza
zählen	contare
benutzer	utente
fördern	promuovere
sultan	sultano
konferenz	convegno
flüssig	liquido
sorte	sorta
nutzlos	inutile
agenten	agenti
inhalt	contenuto
offiziell	ufficialmente
erobert	conquistato
adoptiert	adottato
kultur	cultura
jr	jr
wirklichkeit	realtà
gedanke	pensiero
teilweise	parzialmente
kräfte	forze
modifizieren	modificare
fähigkeit	abilità
heute	oggi
franchi	franchi
schiff	nave
immer	sempre
phase	fase
jg	jg
lernen	imparare
gelb	giallo
fabio	fabio
amerika	america
anwalt	avvocato
fassade	facciata
verwundet	ferito
seite	pagina
unabhängig	indipendente
kuriere	corriere
schmidt	schmidt
unesco	unesco
orgeln	organi
platz	piazza
livorno	livorno
funktion	funzione
hundert	cento
ossia	ossia
leser	lettore
maße	misure
musiker	musicista
spezifisch	specifico
anerkannt	riconosciuto
glorie	gloria
entscheidung	decisione
recent	recente
umgebung	umgebung
agentur	agenzia
offizier	ufficiale
verleger	editore
überschreiten	superare
bestätigung	conferma
florenz	firenze
konfiguration	configurazione
foto	foto
alberto	alberto
minnesota	minnesota
rumänien	romania
belgisch	belga
welcher	quale
kunst	arte
zwölf	dodici
visconti	visconti
bari	bari
beliebtheit	popolarità
kavalier	cavaliere
dezember	dicembre
ritus	rito
perugia	perugia
botschafter	ambasciatore
verkauft	venduto
chicago	chicago
klar	chiaro
kriterien	criteri
harvard	harvard
gespielt	giocato
exemplar	esemplare
ausstattung	allestimento
möglichkeit	possibilità
schließen	chiudere
null	nullo
kanada	canada
seminar	seminario
wahrscheinlich	probabilmente
kloster	monastero
piloten	piloti
carabinieri	carabinieri
kandidat	candidato
hieronymus	girolamo
untersuchung	indagine
studierende	studenti
lukas	luca
kurz	corto
dokumentiert	documentato
punkte	punti
post	posta
luftwaffe	luftwaffe
gedacht	pensato
kontakt	contatto
elisabetta	elisabetta
unmöglich	impossibile
wind	vento
eliminierung	eliminazione
,	,
gesetz	legge
gestalten	gestire
frau	signora
grotte	grotta
schutzhütte	rifugio
märtyrer	martire
dario	dario
park	parco
erweitert	ampliato
dietrich	dietrich
gelingen	riuscire
programm	programma
arabisch	arabo
nach	dopo
variabel	variabile
stufe	gradino
gemessen	misurato
einfügen	inserire
ehe	matrimonio
sozial	sociale
system	sistema
tastatur	tastiera
digital	digitale
spiegel	specchio
geplant	pianificato
rückwärts	indietro
nordöstlich	nordorientale
kreuz	croce
liedermacher	cantautore
terrestre	terrestre
gymnasium	ginnasio
inferiore	inferiore
daher	perciò
therapie	terapia
behauptung	affermazione
schauspielerin	attrice
herr	signore
alpin	alpino
dalle	dalle
entdecken	scoprire
messe	messa
zwanzig	venti
oxford	oxford
inspiriert	ispirato
raymond	raymond
guglielmo	guglielmo
tragen	portare
modi	modi
ludovico	ludovico
schuld	colpa
insel	isola
voll	pieno
ibn	ibn
städtische	städtische
schmerz	dolore
stamm	tronco
teufel	diavolo
https	https
wichtigkeit	importanza
hamburger	hamburger
schneider	sartore
gott	dio
teil	parte
rami	rami
referenz	riferimento
allo	allo
professor	professore
palermo	palermo
regelmäßig	regolarmente
entfernung	distanza
kinder	bambini
sehen	vedere
catania	catania
kevin	kevin
viale	viale
lassen	lasciare
kategorie	categoria
feinde	nemici
laurea	laurea
funktioniert	funziona
grün	verde
emilia	emilia
akteur	attore
medaillen	medaglie
daniel	daniel
halbfinale	semifinale
portugiesisch	portoghese
angepasst	adattato
modern	moderno
archäologisch	archeologico
spielend	giocando
roma	roma
mädchen	ragazza
bühne	palcoscenico
angriffsspieler	attaccante
streifen	striscia
posteriori	posteriori
imperium	impero
verlieren	perdere
farsi	farsi
verkauf	vendita
hafen	porto
gehört	appartiene
englisch	inglese
kommission	commissione
comic	fumetto
akteure	attori
publiziert	pubblicato
john	john
andererseits	altrimenti
bäume	alberi
kollege	collega
bezahlen	pagare
prinzessin	principessa
fürstentum	principato
isabella	isabella
austin	austin
sternbild	costellazione
eine	una
räume	spazi
normale	normale
front	fronte
denken	pensare
bestimmen	determinare
bleibt	rimane
turnier	torneo
haar	capelli
verlassen	abbandonare
kommando	kommando
künste	arti
erreichen	raggiungere
romeo	romeo
spektakel	spettacolo
sand	sabbia
dna	dna
löwe	leone
golf	golf
lösungen	soluzioni
territoriale	territoriale
trennung	separazione
mediterran	mediterraneo
vergessen	dimenticare
zunge	lingua
kalt	freddo
bianchi	bianchi
berg	montagna
gonzaga	gonzaga
juli	luglio
autoconfirmed	autoconfirmed
leipziger	leipziger
küche	cucina
missouri	missouri
irland	irlanda
statue	statua
rgb	rgb
kontinent	continente
marina	marina
theorie	teoria
student	studente
symbol	simbolo
ferrara	ferrara
°	°
strasse	strada
ergebnisse	risultati
beauftragt	incaricato
logik	logica
monza	monza
hessen	hessen
autoren	autori
