führer	вождь
erfurt	эрфурт
nikolaus	nikolay
gewinn	выигрыш
einschränkungen	ограничения
gustav	gustav
saal	зал
rumänien	румыния
fakt	факт
richtungen	направления
premiere	премьера
einrichtung	устройство
grafschaft	графство
halbinsel	полуостров
formierung	формирование
nikolajewna	николаевна
ring	кольцо
markt	рынок
ach	ах
voraussetzungen	предпосылки
idee	идея
nominierungen	номинации
dmitrijewitsch	дмитриевич
haben	иметь
rathaus	ратуша
reaktion	реакция
eingeführt	введенный
jan	ян
prozess	процесс
übersetzung	перевод
brüder	братья
angst	страх
ministerium	министерство
münster	мюнстер
zeiten	времена
umbenennen	переименовать
warnung	предупреждение
regional	региональный
sturm	штурм
eduard	эдуард
feb	feb
papa	папа
themen	темы
besuchte	посетил
problem	проблема
gewinnen	выигрывать
bewegungen	движения
interessiert	интересует
aufmerksamkeit	внимание
tirol	тироль
sänger	певец
geschaffen	созданный
mai	май
schleswig	шлезвиг
zusammenarbeit	сотрудничество
anfrage	запрос
zerstörung	уничтожение
bewegung	движение
spam	спам
einstellung	настройка
aktiv	активный
drehbuchautor	сценарист
admiral	адмирал
arthur	артур
aufbau	aufbau
fernsehen	телевидение
regelmäßig	регулярно
komitee	комитет
polnisch	польский
severa	севера
kontakt	контакт
initiative	инициатива
mehr	больше
schule	школа
wiederherstellung	восстановление
unterstützung	поддержка
österreichische	австрийская
kirche	церковь
logo	логотип
sotschi	сочи
verloren	потерянный
zone	зона
ausgabe	выпуск
formel	формула
unterschrift	подпись
museum	музей
gast	гость
mercedes	мерседес
ukrainische	украинская
sonne	солнце
möglichkeiten	возможности
funktioniert	функционирует
baron	барон
buenos	buenos
sofia	софия
begründung	обоснование
atlas	атлас
auge	глаз
maria	мария
geschichte	история
wahrscheinlich	вероятно
licht	свет
marathon	марафон
dieser	этот
abtei	аббатство
freundschaft	дружба
meyer	meyer
westlich	западный
venedig	венеция
mensch	человек
verantwortung	ответственность
alt	старый
theorie	теория
lieder	lieder
praktisch	практический
microsoft	microsoft
szenario	сценарий
oblast	oblast
dorthin	туда
großbritannien	великобритания
wiktorowitsch	викторович
johnson	джонсон
roman	рома́н
athen	афины
automatisch	автоматически
zufällig	случайный
vandalismus	вандализм
oskar	оскар
trainer	тренер
ereignisse	события
geschäft	бизнес
ökonomisch	экономически
kurz	короткий
text	текст
journalisten	журналисты
prinzipien	принципы
versammlungen	собрания
hannover	ганновер
bruder	брат
münchen	мюнхен
details	подробности
thüringen	тюрингия
schwierig	трудный
universität	университет
mündung	устье
söhne	сыновья
katalog	каталог
abgeordneter	депутат
folgen	следовать
tatjana	татьяна
kirill	кирилл
aspekte	аспекты
tochter	дочь
bischof	епископ
argentinien	аргентина
silber	серебро
mecklenburg	мекленбург
analog	аналоговый
verbesserung	улучшение
organisation	организация
süd	юг
kindheit	детство
sagte	сказал
niederlande	нидерланды
eltern	родители
nacht	ночь
jagd	охота
acht	восемь
kampf	бой
ingenieur	инженер
dirigent	дирижер
dresdner	дрезденский
zonen	зоны
generationen	поколения
integriert	интегрированный
mädchen	девочка
notwendig	необходимый
schweizer	швейцар
bücher	книги
eberhard	эберхард
professor	профессор
richtung	направление
entsprechen	соответствовать
nördlich	северный
zdf	zdf
mario	марио
nation	нация
szene	сцена
pik	пик
tatsächlich	фактически
bank	банк
turm	башня
jurist	юрист
alexejewitsch	алексеевич
natur	природа
schwarz	чёрный
firma	фирма
freundin	подруга
politik	политика
bernd	бернд
eigenschaft	свойство
verwaltung	администрация
ball	мяч
zeit	время
flora	flora
argumente	аргументы
funktionen	функции
heute	сегодня
rahmen	рамка
freunde	друзья
meter	метр
zellen	клетки
südlicher	южный
bürger	гражданин
oberliga	оберлига
victoria	виктория
schild	щит
unser	наш
gitarre	гитара
wohnung	квартира
beiträge	beiträge
nikolai	николай
überblick	обзор
material	материал
hände	руки
semjonowitsch	семёнович
allgemeinen	allgemeinen
vollständig	полностью
motoren	моторы
wittenberg	виттенберг
erscheinungen	явления
urteil	суждение
schlag	удар
inneres	внутреннее
wolf	волк
junioren	юниоры
verbrechen	преступление
ausgestattet	укомплектован
regensburg	регенсбург
markus	маркус
garten	сад
ideen	идеи
chronik	хроника
krasnaja	красная
morgen	утро
springer	прыгун
weiß	белый
zufall	случай
blätter	листья
hafen	гавань
woiwodschaft	воеводство
kärnten	каринтия
wissenschaftlich	научный
versuch	опыт
antwort	ответ
europa	европа
bahnhof	вокзал
warum	почему
lehre	учение
nummer	номер
formulierung	формулировка
gruppe	группа
preisträger	лауреат
wissen	знать
unklar	неясный
projekt	проект
imho	imho
munizipalität	муниципалитет
fähigkeiten	способности
usd	usd
genauer	точнее
jerusalem	иерусалим
amt	амт
jetzt	сейчас
prinz	принц
kaufmann	купец
erzbischof	архиепископ
kandidat	кандидат
anweisungen	указания
trat	трат
stadion	стадион
nord	север
sohn	сын
neutral	нейтральный
geschickt	умелый
negativ	отрицательный
schwerin	шверин
erweiterte	erweiterte
edits	edits
karten	карты
nominierung	номинация
komponist	композитор
stahl	сталь
traditionell	традиционный
kasan	казань
psychologie	психология
sicherheit	безопасность
erfinder	изобретатель
diskussion	дискуссия
valentin	валентин
meldete	сообщил
dvd	dvd
jedem	каждому
gesundheit	здоровье
hamburger	гамбургер
eishockey	хоккей
glaube	вера
jugoslawien	югославия
maschine	машина
bester	лучший
monat	месяц
höhe	высота
gesagt	сказано
darmstadt	darmstadt
untersuchung	исследование
agentur	агентство
hitler	гитлер
polizei	полиция
verstehen	понимать
gelb	жёлтый
verbreitet	распространенный
vorsitzender	председатель
produktion	production
elemente	элементы
verhandlungen	переговоры
dollar	доллар
öffentlichkeit	общественность
euro	евро
prozesse	процессы
porträt	портрет
letzter	последний
beziehungen	beziehungen
albert	альберт
ordnung	порядок
einfluss	влияние
befehl	приказ
career	карьера
geschwindigkeit	скорость
oberster	верховный
oberfläche	поверхность
schatten	тень
magazin	магазин
zustand	состояние
lösungen	решения
unmittelbar	непосредственно
litauen	литвы
unternehmen	предприятие
unabhängigen	независимых
sultan	султан
eroberung	завоевание
infanterie	пехота
deswegen	потому
ergebnisse	результаты
zuschauer	зритель
effekt	эффект
musiker	музыкант
aktivitäten	активности
kritiker	критик
legende	легенда
sonntag	воскресенье
bevölkerung	население
philosophie	философия
demokratie	демократия
stein	камень
simon	симон
völker	народы
internet	интернет
minimum	минимум
khan	хан
imperium	империя
qualifikation	квалификация
abenteuer	приключение
existieren	существовать
boston	бостон
punkt	пункт
israel	израиль
gordon	gordon
washington	вашингтон
toronto	торонто
wachstum	рост
schaden	ущерб
gefahr	опасность
sowjetisch	советский
kopenhagen	копенгаген
teilnehmer	участник
erzählungen	рассказы
ökonomie	экономика
leopold	леопольд
gestern	вчера
baum	древо
einverstanden	согласен
druck	печать
finnland	финляндия
farbe	цвет
geteilt	разделенный
ägypten	египет
exemplare	экземпляры
elisabeth	елизавета
frank	франк
spezialist	специалист
bielefeld	билефельд
seite	страница
wissenschaftliche	научная
mathematik	математика
erworben	приобретенный
francesco	франческо
armee	армия
dritte	третья
kulturen	культуры
emil	эмиль
kasachstan	казахстан
portugal	португалия
abraham	авраам
korea	корея
komödie	комедия
stärker	сильнее
digital	цифровой
blues	блюз
kontrolle	контроль
kommandierender	командующий
marx	маркс
handel	торговля
wilhelm	вильгельм
nürnberger	нюрнбергский
geschlossen	закрытый
mächtigkeit	мощность
weimarer	веймарский
linz	линц
brandenburg	бранденбург
argumentation	аргументация
charakteristiken	характеристики
usa	usa
beschäftigt	занятый
grün	зеленый
martin	martin
friedrich	фридрих
chance	шанс
mitarbeiter	сотрудник
elektrische	электрическая
kreise	круги
damen	дамы
schlesien	силезия
klavier	пианино
dramaturg	драматург
kamera	камера
mog	мог
verantwortlich	ответственный
enthält	содержит
flucht	бегство
föderation	федерация
verhindern	препятствовать
theorien	теории
harald	harald
verlängerung	удлинение
junior	юниор
fussballspieler	футболист
ukas	указ
enthalten	содержать
sechs	шесть
griechenland	греция
uefa	uefa
prüfung	проверка
magdeburg	магдебург
nichts	ничто
senat	сенат
gegebenes	данное
kurs	курс
symbol	символ
organisationen	организации
ausgaben	расходы
kontext	контекст
umleitung	перенаправление
moment	момент
plattform	платформа
aufzeichnung	запись
auflage	auflage
ständig	постоянно
trio	трио
medizinischen	медицинских
benedikt	бенедикт
basel	базель
kopf	голова
synagoge	синагога
jena	jena
wissenschaftler	ученый
enthalpie	энтальпия
zarentum	царство
himmel	небо
beschädigt	поврежден
früher	раньше
prinzessin	принцесса
wusste	знал
oper	опера
körper	тело
rgb	rgb
fenster	окно
philadelphia	филадельфия
bruno	бруно
schritt	шаг
anton	антон
italienisch	итальянский
lang	длинный
pfalz	pfalz
braun	braun
wladimir	влади́мир
millimeter	миллиметр
zentral	центральный
insel	остров
radio	радио
revolution	революция
provinz	провинция
anwalt	адвокат
professur	профессура
lon_deg	lon_deg
hauptstadt	столица
millionen	миллионы
geographische	географическое
administrator	администратор
heinrich	гейнрих
liter	литр
bronze	бронза
valentina	валентина
liga	лига
bundesliga	бундеслига
vereinigung	объединение
funktion	функция
sebastian	себастьян
qualitäten	качества
herzog	герцог
bestimmt	определенный
selbst	сам
server	сервер
wollten	хотели
ikonen	иконы
erzählung	рассказ
größe	величина
winter	зима
abwesenheit	отсутствие
aufstand	восстание
nassau	nassau
hauptmann	гауптман
veranstaltung	мероприятие
kunden	клиенты
expedition	экспедиция
douglas	дуглас
kontinentale	континентальный
produzierte	производил
identität	идентичность
verurteilt	осужден
absolut	абсолют
gesellschaft	общество
interessen	интересы
generation	поколение
fischer	рыбак
irland	ирландия
wächst	растёт
html	html
luxemburg	люксембург
pflege	уход
regie	режиссура
verfolgung	преследование
hartmann	hartmann
schneider	шнайдер
überschrift	заголовок
phase	фаза
orchester	оркестр
menge	множество
ausstellung	выставка
url	url
turnier	турнир
voll	полный
dnepr	днепр
erweiterung	расширение
graf	граф
campus	кампус
santa	santa
vorlesungen	лекции
status	статус
beschreibung	описание
vermeiden	избегать
hektar	гектар
reise	путешествие
nominiert	номинированный
nationalsozialismus	нацизм
zürich	цюрих
vier	четыре
grigori	григорий
episode	эпизод
gleichzeitig	одновременно
netz	сеть
golf	гольф
standard	стандарт
stufe	ступень
suche	поиск
kommunikation	коммуникация
unternehmer	предприниматель
bulgarien	булгария
schweden	шведы
wolfgang	вольфганг
eindruck	впечатление
ivanov	иванов
und/oder	и/или
opfer	жертва
offizier	офицер
relevant	relevant
aktion	акция
produziert	производит
arnold	арнольд
wein	вин
schwer	тяжёлый
tourismus	туризм
dokumente	документы
olympischer	олимпийский
konzept	концепт
operation	операция
anime	аниме
erwarten	ожидать
versuchen	попробовать
aleksey	алексей
johnny	джонни
straße	улица
staat	государство
hamilton	гамильтон
kriege	войны
wikimedia	викимедиа
folgte	следовал
verfassung	конституция
kriterium	критерий
wagner	вагнер
korrekt	корректный
manfred	манфред
hören	слушать
durchgehen	пройти
angebot	предложение
maximal	максимальный
bundestag	бундестаг
stepanowitsch	степанович
gedicht	стихотворение
reformation	реформация
innerer	внутренний
soziologie	социология
vögel	птицы
betrachten	рассматривать
virginia	вирджиния
frieden	мир
mechanismus	механизм
wiki	вики
teilweise	частично
einheit	einheit
erste	первая
schriftsteller	писатель
erde	земля
konzerte	концерты
verbindung	соединение
bremen	бремен
klub	клуб
staatsangehörigkeit	гражданство
wort	слово
biografie	biografija
systematik	систематика
konzert	концерт
kardinal	кардинал
wille	воля
bischöfe	епископы
arzt	врач
minute	минута
meinem	моему
dortmund	дортмунд
stunde	час
kapitän	капитан
interesse	интерес
other	другой
james	джеймс
wappen	герб
angepasst	приспособленный
eigentum	собственность
thailand	таиланд
kategorie	категория
benjamin	бенджамин
kritisch	критический
physiker	физик
alles	все
ursula	урсула
krankenhaus	госпиталь
strukturen	структуры
essen	ешь
archäologie	археология
werner	вернер
super	супер
inkubator	инкубатор
saarbrücken	saarbrücken
finally	наконец
kapelle	капелла
alfred	альфред
abhängig	зависимый
marina	марина
variante	вариант
york	йорк
poly	poly
herbst	осень
instrument	инструмент
oldenburg	ольденбург
felix	феликс
florian	флориан
beispiele	примеры
göttingen	гёттинген
besser	лучше
warschau	варшава
eis	лёд
holz	древесина
koblenz	кобленц
lehrkräfte	преподаватели
erinnerungen	воспоминания
morgens	утром
juden	евреи
gesicht	лицо
ursachen	причины
julia	юлия
diplomat	дипломат
stil	стиль
paris	париж
isbn	isbn
meer	море
freiheit	svoboda
kompositionen	композиции
gemälde	картина
villa	вилла
besuch	визит
halb	полу
werkstatt	мастерская
arbeiten	работать
umfang	обхват
kloster	монастырь
leser	читатель
verluste	убытки
engel	ангел
luftwaffe	воздушные
enzyklopädien	энциклопедии
kombination	комбинация
tätigkeit	деятельность
macht	власть
redaktion	редакция
marburg	марбург
klima	климата
stärke	сила
jahrhundert	век
asteroid	астероид
handeln	торговать
theologe	теолог
freiburg	фрайбург
uni	uni
sterben	умирать
organisiert	организованный
bistum	епископство
witwe	вдова
amsterdam	амстердам
heiliger	святой
liegen	лежать
leutnant	лейтенант
jesus	иисус
gewinnt	выигрывает
gräfin	графиня
buchstaben	буквы
besitzen	владеть
präsident	президент
bildhauer	скульптор
spiele	игры
lehrer	учитель
leben	жизнь
fliegen	летать
unentschieden	ничья
augsburg	аугсбург
blick	взгляд
praktika	практика
ukrainisch	украинский
modern	модерн
dienstleistungen	услуги
oxford	оксфорд
königreich	королевство
stuttgart	штутгарт
fürstentum	княжество
olga	ольга
ursache	причина
dokumentation	документация
wasser	вода
königlich	королевский
parameter	параметр
möchte	хочет
hund	собака
laboratorien	лаборатории
foto	фото
erklären	объяснять
schablonen	шаблоны
laut	громкий
linke	левая
pennsylvania	пенсильвания
ludwig	людвиг
dynastie	династия
van	ван
veröffentlichung	публикация
kommentare	комментарии
einfach	просто
realität	реальность
geben	давать
professioneller	профессиональный
schmidt	шмидт
pseudonym	псевдоним
kathedrale	собор
lizenz	лицензия
giovanni	джованни
pflanze	растение
stehen	стоять
david	давид
leicht	легкий
staatliche	государственная
klasse	класс
fakultät	факультет
geschützt	защищенный
landschaft	ландшафт
sammeln	собирать
gefangenschaft	плен
reisen	путешествовать
assistent	ассистент
dame	дама
arbeiter	рабочий
beschreibt	описывает
indiana	индиана
umgeben	окружать
stellvertreter	заместитель
schottland	шотландия
wald	лес
sieger	победитель
richard	ричард
sergej	сергей
drittel	треть
,	,
jazz	джаз
kanada	канада
müller	мюллер
zuviel	слишком
verstärkt	усиленный
dolgen	должен
fuchs	лис
sportler	спортсмен
widerstand	сопротивление
wissenschaften	науки
lesen	читать
tempo	темп
zeichen	знак
folglich	следовательно
kaufte	купил
autobahn	автобан
königin	королева
programm	программа
christian	христиан
forum	форум
ecke	угол
ferdinand	фердинанд
dynamo	динамо
bibel	библия
identifikator	идентификатор
kolonie	колония
fulda	фульда
nhl	nhl
sicherung	обеспечение
chemie	химия
offiziell	официальный
kollektiv	коллектив
langsam	медленно
schwach	слабый
ärzte	врачи
%be%d	%be%d
büro	бюро
september	сентябрь
disk	диск
kultur	культура
schnell	schnell
vorbereitung	подготовка
technik	техника
anwendung	применение
max	макс
toni	тони
spieler	игрок
erreichen	достигнуть
bewertung	оценка
november	ноябрь
fahrer	водитель
nikolajewitsch	николаевич
verwendung	употребление
suchen	искать
verzeichnis	verzeichnis
mein	мой
erkennbar	узнаваемый
hand	рука
beitrag	beitrag
eigenschaften	свойства
bauen	строить
lat_deg	lat_deg
raum	пространство
stadt	gorod
geist	дух
malerei	живопись
minnesota	миннесота
konflikt	конфликт
original	оригинал
aufgaben	задачи
mainz	майнц
gericht	суд
jede	каждая
juli	июль
köln	кёльн
typisch	типичный
kino	кино
nicht	нет
achievements	достижения
post	пост
bernard	бернард
messe	месса
iso	iso
uhr	часы
persönlichkeiten	личности
fassade	фасад
absolventen	выпускники
jäger	охотник
gelesen	прочитано
spanisch	испанский
information	информация
kalifornien	калифорния
brigade	бригада
abt	абт
gang	ганг
näher	ближе
bewusst	сознательный
infobox	инфобокс
indizes	индексы
interwikis	интервики
ausdruck	выражение
umgebung	окрестность
bataillon	батальон
fabrik	фабрика
priester	priest
flotte	флот
nachrichten	nachrichten
pokal	кубок
dienen	служить
analyse	анализ
jakob	яков
tanz	танец
altar	алтарь
erklärung	объяснение
zeitschriften	журналы
fritz	фриц
maler	maler
untersuchungen	исследования
berlin	берлин
fjodorowitsch	фёдорович
australien	австралия
entfernt	удаленный
konkurrenz	конкуренция
braunschweig	брауншвейг
männlich	мужской
versteht	понимает
jury	жюри
wie	как
januar	январь
georg	георгий
neun	девять
beispiel	пример
planung	планирование
verkauft	проданный
lp	lp
werbung	реклама
ziel	цель
bucht	бухта
vertrag	договор
film	фильм
technologie	технология
norwegen	норвегия
aktuell	актуальный
sydney	сидней
verbindet	соединяет
filip	филипп
meinung	мнение
flügel	крыло
erlaubnis	разрешение
kontrakt	контракт
roland	роланд
freund	друг
thomas	томас
milliarden	миллиарды
anhänger	прицеп
entscheidend	решающий
wollte	хотел
brief	brief
fotografie	фотография
motor	мотор
vaterländische	отечественная
domäne	домен
spektakel	спектакль
modell	модель
portal	портал
tiere	животные
feuer	огонь
maximilian	максимилиан
partei	партия
ergebnis	результат
sport	спорт
glück	счастье
österreich	австрия
dach	крыша
dm	dm
paderborn	падерборн
weise	мудрый
hildesheim	hildesheim
fotograf	фотограф
kommission	комиссия
russland	россия
haus	дом
bibliothek	библиотека
wissenschaft	наука
evangelisch	евангелический
gymnasium	гимназия
plus	плюс
eingang	вход
lon_min	lon_min
charakter	характер
begraben	похоронен
wettkämpfe	соревнования
sterne	звезды
endgültig	окончательный
zitat	цитата
jurij	юрий
beobachten	наблюдать
autor	автор
andrejewitsch	андреевич
japanisch	японский
frage	вопрос
glas	стекло
fussball	футбол
nutzer	пользователь
vorgänger	предшественник
vergleichbar	сравнимый
erwartet	ожидает
anmerkungen	заметки
musikalisch	музыкальный
schreiben	писать
plan	план
schiff	корабль
erwähnung	упоминание
pianist	пианист
anforderungen	требования
allmählich	постепенно
daten	данные
zentimeter	сантиметр
rekord	рекорд
vergangenheit	прошлое
kassel	кассель
lernen	учиться
rückwärts	назад
format	формат
historiker	историк
herzogtum	герцогство
kritik	критика
bewaffnung	вооружение
verbessern	улучшать
karl	карл
nürnberg	нюрнберг
württemberg	вюртемберг
kämpfen	бороться
autoconfirmed	autoconfirmed
minister	министр
zeichnungen	рисунки
redakteur	редактор
beliebtheit	популярность
unabhängig	независимый
fähigkeit	способность
general	генерал
krone	корона
militärisch	военный
verstehe	понимаю
biologie	биология
verhalten	поведение
tübingen	тюбинген
kathedra	кафедра
heidelberg	гейдельберг
beschreiben	описывать
genau	точно
robert	роберт
historischer	исторический
kavalier	кавалер
drei	три
leer	пустой
korrespondent	корреспондент
gouverneur	губернатор
tunnel	туннель
lager	лагерь
stefan	стефан
infrastruktur	инфраструктура
recht	право
ehefrau	супруга
varianten	варианты
architekt	архитектор
entfernen	удалить
anfang	начало
eigentümer	владелец
manuel	мануэль
florenz	флоренция
schablone	шаблон
computer	компьютер
neapel	неаполь
ansprüche	претензии
säuren	кислоты
spielen	играть
entwickelung	развитие
frankreich	франция
erbe	наследство
städtisch	городской
materialien	материалы
jeder	каждый
spanien	испания
roger	roger
volkszählung	перепись
tür	дверь
unmöglich	невозможно
moskau	москва
hessen	гессен
alexandra	александра
wunsch	желание
leiden	страдать
vorstellungen	представления
besitz	владение
presse	пресса
eugenia	евгения
abend	вечер
franz	франц
herz	сердце
temperatur	температура
statistik	статистика
japan	япония
alexandrowna	александровна
dein	твой
medizinische	медицинская
sand	песок
natürlich	естественно
preliminary	предварительный
geographie	география
staatliches	государственное
mutter	мать
figur	фигура
möglicherweise	возможно
arena	арена
hoch	высокий
buch	бух
arbeit	труд
akademie	академия
konstruktion	конструкция
rechts	правый
eva	ева
anschluss	аншлюс
wiesbaden	висбаден
stimme	голос
syndrom	синдром
zeitung	газета
autoren	авторы
unzureichend	недостаточно
deine	твоя
bamberg	бамберг
gefängnis	тюрьма
forderte	потребовал
anlass	повод
frankfurter	frankfurter
jugendliche	молодёжный
krankheit	болезнь
häufig	часто
kritisiert	критикует
kolonien	колонии
erwin	эрвин
mord	убийство
zukunft	будущее
sergejewitsch	сергеевич
ausgang	выход
ddr	ddr
adam	adam
schön	красивый
automobil	автомобиль
alexander	alexander
bestimmen	определять
liebe	любовь
vogel	птица
mythologie	мифология
verleger	издатель
bürgermeister	бургомистр
physik	физика
fünf	пять
pädagoge	педагог
berliner	берлинер
integration	интеграция
nato	nato
verlag	издательство
partner	партнер
elf	эльф
mark	марка
akademiker	академик
besaß	владел
aufmerksam	внимательный
unerwartet	неожиданно
könig	король
profil	профиль
kooperation	кооперация
unverzüglich	немедленно
innsbruck	инсбрук
dynamik	динамика
pawel	павел
eparchie	епархия
mauer	стена
sphäre	сфера
fort	форт
apr	apr
chef	шеф
amerikaner	американец
gesetze	законы
gewissen	совесть
ulrich	ульрих
luther	лютер
kristalle	кристаллы
präfektur	префектура
sieben	семь
fällt	падает
planeten	планеты
entdeckungen	открытия
april	апрель
schneller	быстрее
dj	диджей
hugo	hugo
ivan	иван
unabhängigkeit	независимость
phrasen	фразы
dietrich	dietrich
bedingungen	условия
dresden	дрезден
protokoll	протокол
operator	оператор
chemiker	химик
ausnahme	исключение
potsdam	потсдам
sängerin	певица
musik	музыка
argument	аргумент
viertelfinale	четвертьфинал
zentrum	центр
direktor	директор
existenz	существование
tschechien	чехия
tor	тор
basketball	баскетбол
thema	тема
charlotte	шарлотта
lemma	лемма
manager	менеджер
fakten	факты
tausend	тысяча
technologien	технологии
situation	ситуация
literatur	literatura
kommentar	комментарий
prospekt	проспект
gesandtschaft	посольство
kroatien	хорватия
schiedsrichter	судья
japanische	японская
barcelona	барселона
sternbild	созвездие
anfängt	начинается
gerhard	герхард
enzyklopädisch	энциклопедический
zar	царь
zyklus	цикл
konstanz	констанция
bergen	берген
png	png
kabinett	кабинет
papier	бумага
weg	путь
veröffentlichungen	публикации
lat_sec	lat_sec
doktor	доктор
theologie	теология
journalist	журналист
schwierigkeiten	трудности
feld	поле
tabelle	таблица
gold	золото
prinzip	принцип
linien	линии
schriftstellerin	писательница
bmw	bmw
prüfungen	испытания
neuer	новый
wörterbuch	словарь
sekretär	секретарь
typ	тип
entfernung	расстояние
dritter	третий
rheinland	рейнланд
möglichkeit	возможность
schema	схема
parlament	парламент
sergeant	сержант
durchmesser	диаметр
zeigen	показывать
international	международный
oleg	олег
evangelischen	евангельских
festung	крепость
allgemeiner	общий
struktur	структура
viertel	четверть
positiv	положительный
synonym	синоним
konstantinowitsch	константинович
kanton	кантон
ulm	ульм
jugend	молодёжь
rudolf	рудольф
identisch	идентичен
reihen	ряды
institut	институт
holstein	гольштейн
block	блок
therapie	терапия
offensichtlich	очевидно
berg	гора
bayerische	баварская
blatt	лист
index	индекс
dokumentar	документальный
minsk	минск
prag	prag
griff	гриф
ips	ips
unesco	unesco
system	система
würzburg	вюрцбург
wellen	волны
las	лас
stockholm	стокгольм
koordinaten	координаты
später	позже
staatlich	государственный
antworten	отвечать
albrecht	альбрехт
schewtschenko	шевченко
familie	семья
inhalt	содержание
hollywood	голливуд
hilfe	помощи
vorschläge	предложения
verboten	запрещённый
zwölf	двенадцать
fonds	фонд
kandidatur	кандидатура
dezember	декабрь
monate	месяцы
machen	сделать
architektur	архитектура
zusätzlich	дополнительно
hochzeit	свадьба
kreuz	крест
jährlich	ежегодно
akademien	академии
dissertation	диссертация
zitiert	цитируется
produkt	продукт
werte	ценности
klassische	классическая
christus	христос
ludmilla	людмила
jura	юра
islam	ислам
konkret	конкретно
februar	февраль
jakowlewitsch	яковлевич
oktober	октябрь
wachsen	расти
kosmos	космос
begriff	понятие
versammlung	собрание
linux	линукс
energie	энергия
senator	сенатор
übereinkunft	соглашение
konferenz	конференция
religion	религия
erfolge	успехи
rose	роза
budapest	будапешт
chor	хор
brüssel	брюссель
formal	формальный
vorteil	преимущество
walther	валтер
linie	линия
klinik	клиника
spiegel	зеркало
benutzen	пользоваться
zeitweilig	временно
teilen	разделять
eindeutig	однозначно
theater	театр
interview	интервью
verheiratet	замужем
korps	корпус
gespräch	разговор
erfolgreich	успешный
the	the
angriff	нападение
ähnlich	похожий
grad	градус
besonderer	besonderer
karlsruhe	карлсруэ
gesetz	закон
iwanowitsch	иванович
adler	орёл
krieg	война
politiker	политик
fehler	ошибка
din	дин
josé	josé
soldaten	солдаты
leipzig	лейпциг
%bd%d	%bd%d
warteschlange	очередь
schwester	сестра
lat_min	lat_min
medaille	медаль
breslau	бреславль
satellit	спутник
schicksal	судьба
einleitung	введение
konstruktionen	конструкции
löwe	лев
diesem	этому
youtube	ютуб
erinnerung	воспоминание
verbreitung	распространение
august	август
lokomotiven	локомотивы
clemens	clemens
archiv	архив
konrad	конрад
tief	глубокий
verdienste	заслуги
abs	абс
if	если
republik	республика
karte	карта
ritter	рыцарь
belgien	бельгия
brücke	мост
florida	florida
ereignis	событие
english	английский
schrift	шрифт
istanbul	istanbul
interessant	интересный
quellen	источники
mexiko	мексика
beobachtungen	наблюдения
photographien	фотографии
weißrussisch	белорусский
hoffnung	надежда
niemand	никто
amerikanisch	американский
aufgabe	задача
wahrnehmung	восприятие
fjodor	фёдор
glauben	верить
wichtig	важный
philosoph	философ
volkstümlich	народный
wahrheit	истина
wikipedia	википедия
umbenennung	переименование
kontakte	контакты
friedhof	кладбище
sprint	спринт
methode	метод
feuerwehr	пожарная
umbenannt	переименованный
ersetzen	заменять
horn	рог
sachsen	саксония
abkürzung	сокращение
solid	солид
rektor	ректор
fraktion	фракция
übersetzer	переводчик
territorium	территория
töchter	дочери
beschrieben	описанный
nähe	близость
gott	бог
bot	бот
amerika	америка
bearbeitung	обработка
halbfinale	полуфинал
weiter	дальше
produzent	продюсер
maße	меры
schließt	закрывает
gitarrist	гитарист
drama	драма
besucher	посетитель
punkte	пункты
fürstentümer	княжества
verkauf	продажа
anerkennung	признание
peking	пекин
period	период
genre	жанр
lösung	решение
metro	метро
schlaginstrumente	ударные
durchbruch	прорыв
lon_sec	lon_sec
blau	синий
profession	профессия
luft	воздух
studio	студия
berichte	berichte
falsch	ложный
zimmer	комната
museen	музеи
volk	народ
adolf	адольф
bbc	bbc
kräfte	силы
helfen	помогать
vater	отец
front	фронт
tausende	тысячи
hinzufügen	добавить
disziplin	дисциплина
kanal	канал
soldat	солдат
frankfurt	frankfurt
industrie	промышленность
moritz	мориц
sprach	язык
sitzen	сидеть
rezeption	рецепция
fluss	река
flughafen	аэропорт
untersucht	исследуется
vergessen	забыть
konstantin	константин
medizin	медицина
wohin	куда
enzyklopädie	enciklopedija
technischer	технический
stanislaw	станислав
notwendigkeit	необходимость
produkte	продукты
märz	март
park	парк
mauern	стены
abbildungen	изображения
leonid	леонид
gibt	дает
nebenflüsse	притоки
verkaufen	продавать
afrika	африка
diskutieren	дискутировать
form	форма
fürst	князь
erziehung	воспитание
verbot	запрет
