undecided	unentschieden
wing	flügel
sprachen	sprachen
scientifically	wissenschaftlich
brazil	brasilien
augsburg	augsburg
runner	läufer
analog	analog
lost	verloren
one	eins
improvement	verbesserung
meat	fleisch
plan	plan
prices	preise
zeichnungen	zeichnungen
girlfriend	freundin
writings	schriften
portland	portland
terminal	terminal
offensive	offensiv
marx	marx
meter	meter
click	klick
biography	biografie
moritz	moritz
reserves	reserven
process	prozess
inventor	erfinder
abo	abo
plus	plus
jordan	jordan
kreise	kreise
states	staaten
bulgarian	bulgarisch
pianist	pianist
night	nacht
more	mehr
lowest	niedrigster
bureau	büro
strasbourg	straßburg
guitar	gitarre
aspect	aspekt
this	dieser
phase	phase
gilbert	gilbert
mississippi	mississippi
between	between
barry	barry
population	bevölkerung
mio	mio
and	und
zdf	zdf
houston	houston
surroundings	umgebung
downtown	downtown
soldier	soldat
encyclopedia	enzyklopädie
self	selbst
million	million
resulting	resultierend
harald	harald
clubnat	clubnat
walter	walter
extra	extra
rocky	felsig
creator	schöpfer
mills	mühlen
shield	schild
considerable	beträchtlich
published	publiziert
report	bericht
reduced	reduziert
citizen	staatsbürger
pakistani	pakistanisch
mario	mario
hunt	jagd
digital	digital
matthew	matthäus
acceptable	akzeptabel
past	vergangenheit
spanish	spanisch
commentary	kommentar
thank	danke
bush	busch
weblinks	weblinks
systematics	systematik
copyright	urheberrecht
restaurant	restaurant
subject	subjekt
petersburg	petersburg
goethe	goethe
marcel	marcel
flowers	blumen
croatia	kroatien
possibility	möglichkeit
rocket	rakete
scene	szene
horn	horn
aufl	aufl
ross	ross
independent	unabhängig
components	bestandteile
ministers	ministers
hair	haar
kansas	kansas
adjacent	adjacent
favor	favor
minority	minderheit
abilities	fähigkeiten
methods	methoden
schmidt	schmidt
full	voll
johnny	johnny
nations	nationen
finally	schliesslich
effect	wirkung
hanau	hanau
events	ereignisse
brigade	brigade
montreal	montreal
trat	trat
sieger	sieger
cultural	kulturell
juli	juli
fan	fan
musical	musikalisch
options	optionen
abraham	abraham
trainer	trainer
universities	universitäten
darin	darin
lied	lied
clubs	clubs
elbe	elbe
guardian	vormund
video	video
chronicle	chronik
obligated	verpflichtet
inscription	inschrift
competitions	wettbewerbe
nebraska	nebraska
unesco	unesco
colleges	kollegien
magdeburg	magdeburg
intelligence	intelligenz
brisbane	brisbane
saskatchewan	saskatchewan
forest	wald
mission	mission
editor	redakteur
touring	touring
block	block
warfare	kriegsführung
royal	königlich
twice	zweimal
succession	nachfolge
beach	strand
times	zeiten
private	privat
who	wer
insofar	insofern
abfluss	abfluss
suddenly	plötzlich
programming	programmierung
imperial	kaiserlich
poem	gedicht
markus	markus
nine	neun
question	frage
bears	bären
jersey	jersey
norfolk	norfolk
thailand	thailand
summary	zusammenfassung
john	john
invasion	invasion
kevin	kevin
album	album
component	bestandteil
needs	bedürfnisse
archaeological	archäologisch
days	tage
technical	technisch
noble	adelig
revolution	revolution
ulrich	ulrich
project	projekt
mass	masse
organisations	organisationen
interpretation	interpretation
class	klasse
scholars	gelehrten
christmas	weihnachten
friedrich	friedrich
spitze	spitze
jahre	jahre
exposure	exposure
worker	arbeiter
reality	wirklichkeit
ober	ober
soldaten	soldaten
erfurt	erfurt
summer	sommer
cardinals	kardinäle
income	einkommen
zwei	two
gary	gary
culture	kultur
dar	dar
race	rasse
einziger	einziger
orange	orange
daniel	daniel
horses	pferde
resistance	widerstand
types	typen
chancellor	kanzler
advantage	vorteil
medium	medium
india	indien
knew	wusste
equipped	ausgestattet
hut	hütte
communist	kommunist
swiss	schweizer
canton	kanton
jahren	jahren
interesting	interessant
comparison	vergleichung
sucht	sucht
islam	islam
brazilian	brasilianisch
games	spiele
alexander	alexander
continuation	fortsetzung
spring	frühling
ryan	ryan
brain	gehirn
consumer	verbraucher
dictionary	wörterbuch
control	kontrolle
reinforced	verstärkt
provincial	provinzial
mother	mutter
newcastle	newcastle
robert	robert
chess	schach
lyrics	lyrics
jerusalem	jerusalem
hitler	hitler
retreat	rückzug
suicide	selbstmord
chapel	kapelle
islamic	islamisch
deep	tief
dokumentation	dokumentation
cotton	baumwolle
october	oktober
touchdown	touchdown
washington	washington
spider	spinne
michigan	michigan
jonathan	jonathan
saarbrücken	saarbrücken
officer	offizier
filmed	gefilmt
hangs	hängt
saw	säge
athletics	leichtathletik
tropical	tropisch
visited	besucht
solution	lösung
clark	clark
rom	rom
motive	motiv
liverpool	liverpool
impression	eindruck
urls	urls
invited	eingeladen
fact	tatsache
parties	parteien
twenty	zwanzig
feelings	gefühle
projects	projekte
sullivan	sullivan
files	dateien
campbell	campbell
bells	glocken
roger	roger
late	spät
styria	steiermark
warned	gewarnt
quarter	viertel
hampshire	hampshire
rarer	seltener
forests	wälder
prepared	vorbereitet
jones	jones
always	immer
jose	jose
progress	fortschritt
danube	donau
tommy	tommy
clinic	klinik
commission	kommission
allgemeine	allgemeine
predecessor	vorgänger
properties	eigenschaften
media	medien
machine	maschine
pilot	pilot
boxing	boxen
lebanon	libanon
reine	reine
contact	kontakt
factory	fabrik
wladimir	wladimir
robin	rotkehlchen
percentage	prozentsatz
appointment	verabredung
bridges	brücken
photography	fotografie
comics	comics
sociology	soziologie
serial	seriennummer
northwest	nordwest
squad	squad
dance	tanz
won	gewonnen
episode	episode
mountain	berg
step	schritt
speed	geschwindigkeit
albert	albert
archive	archiv
preparation	vorbereitung
model	modell
doubt	zweifel
hab	hab
athletes	athleten
formulation	formulierung
fox	fuchs
zurich	zürich
untersuchung	untersuchung
radical	radikal
kapitän	kapitän
distance	entfernung
interior	innenraum
productions	produktionen
erst	erst
parker	parker
railroad	eisenbahn
initiated	initiiert
baker	bäcker
longs	longs
palm	palme
geography	geographie
einmal	einmal
wickets	wickets
composed	komponiert
nominations	nominierungen
script	skript
bot	bot
wedding	hochzeit
korea	korea
alben	alben
middle	mitte
description	beschreibung
capacity	kapazität
schüler	schüler
hello	hallo
author	verfasser
prose	prosa
journalism	journalismus
condemned	verurteilt
alone	allein
vision	vision
württemberg	württemberg
fighter	kämpfer
evidence	beweismittel
essex	essex
marketing	marketing
schnell	schnell
archbishop	erzbischof
villages	dörfer
bernard	bernard
mündung	mündung
experts	experten
denver	denver
reputation	reputation
electronic	elektronisch
georgia	georgien
murdered	ermordet
munich	münchen
innsbruck	innsbruck
identically	identisch
hope	hoffnung
qualified	qualifiziert
celtic	keltisch
navigation	navigation
nürnberger	nürnberger
influence	einfluss
rule	regel
scenes	szenen
nickname	spitzname
archives	archiven
publisher	verleger
later	später
democracy	demokratie
indiana	indiana
entwurf	entwurf
forces	kräfte
melding	meldung
transportation	transportation
warren	warren
russia	russland
florence	florenz
dresdner	dresdner
philippines	philippinen
few	wenige
lie	lüge
suspicion	verdacht
month	monat
cell	zelle
sculpture	skulptur
theme	thema
regulation	regelung
police	polizei
appearances	erscheinungen
jap	jap
history,	geschichte
warsaw	warszawa
representatives	repräsentanten
policies	policies
centers	zentren
possible	möglich
why	warum
doors	türen
closeness	nähe
günter	günter
arkansas	arkansas
initiative	initiative
saudi	saudi
diseases	krankheiten
dissolved	aufgelöst
sisters	schwestern
schulen	schulen
filmography	filmografie
green	grün
tournaments	turniere
sacrifice	opfer
party	party
mainstream	hauptstrom
weapons	waffen
surgery	chirurgie
gerhard	gerhard
materials	materialien
sentences	sätze
maritime	maritim
father	vater
online	online
lane	lane
kim	kim
thirty	dreißig
destroyed	zerstört
faculty	fakultät
owner	eigentümer
distribution	verteilung
statue	statue
basel	basel
figures	figuren
pirates	piraten
situations	situationen
democratic	demokratisch
endangered	gefährdet
performances	aufführungen
sourcing	sourcing
willi	willi
landscape	landschaft
dean	dekan
expedition	expedition
punk	punk
advertisement	werbung
constitutional	konstitutionell
neumann	neumann
animals	tiere
cited	zitiert
then	dann
hundred	hundert
dangers	gefahren
attorney	rechtsanwalt
protein	protein
indigenous	einheimisch
monastery	kloster
acid	säure
sung	gesungen
slowly	langsam
method	methode
host	gastgeber
clinton	clinton
identification	identifikation
birmingham	birmingham
man	mann
rhineland	rheinland
animated	animiert
belonging	zugehörigkeit
harris	harris
muster	muster
danny	danny
clear	klar
bull	stier
orchestra	orchester
under	unter
bear	bär
lloyd	lloyd
missouri	missouri
journalists	journalisten
north	nord
hours	stunden
irrelevant	irrelevant
line,	linie
strategy	strategie
architecture	architektur
expenditures	ausgaben
months	monate
fuel	brennstoff
adventure	abenteuer
grass	gras
son	sohn
routes	routen
hildesheim	hildesheim
förderung	förderung
money	geld
salzburger	salzburger
senior	senior
eu	eu
altar	altar
arizona	arizona
certified	zertifiziert
easier	einfacher
shall	shall
christi	christi
leeds	leeds
jazz	jazz
christoph	christoph
unless	unless
claude	claude
fought	kämpfte
faces	gesichter
secretary	sekretärin
merit	verdienst
pagename	pagename
screenwriter	drehbuchautor
sri	sri
letters	buchstaben
and/or	und/oder
rejected	abgelehnt
scotland	schottland
winter	winter
remix	remix
wise	weise
bowl	bowl
violin	geige
exclusive	exklusiv
concrete	beton
kerala	kerala
hugo	hugo
weaver	weber
weekend	wochenende
cloud	wolke
progressive	fortschrittlich
raw	roh
dancing	tanzend
stuart	stuart
everything	alles
linear	linear
heads	köpfe
market	markt
bed	bett
genus	gattung
arnold	arnold
classic	klassiker
ältere	ältere
ursula	ursula
infantry	infanterie
concert	konzert
library	bibliothek
addition	addition
licence	lizenz
expansion	ausdehnung
bochum	bochum
brother	bruder
apartment	appartement
arrival	ankunft
actresses	schauspielerinnen
sand	sand
translator	übersetzer
würzburg	würzburg
highest	höchsten
shakespeare	shakespeare
simon	simon
root	wurzel
howard	howard
fusion	fusion
virgin	jungfrau
enemy	feind
nation	nation
joseph	joseph
agent	agent
price	preis
dynasty	dynastie
papers	papiere
halt	halt
potential	potenzial
wiesbaden	wiesbaden
candidacy	kandidatur
hometown	heimatstadt
burgomaster	bürgermeister
network	netzwerk
important	wichtig
occupied	besetzt
argument	argument
concerts	konzerte
longer	länger
ruf	ruf
dragon	drache
sculptor	bildhauer
construction	konstruktion
tournament	turnier
supreme	supreme
francesco	francesco
european	europäisch
weight	gewicht
website	webseite
populations	populations
charlie	charlie
merits	verdienste
attack	angriff
thither	dorthin
socialist	sozialist
entrance	eintritt
coaching	coaching
keith	keith
dave	dave
bearbeitet	bearbeitet
patrol	patrouille
statement	aussage
basketball	basketball
jurisdiction	jurisdiktion
french	französisch
belgium	belgien
throne	thron
musician	musiker
mtv	mtv
george	georg
missing	vermisst
free	kostenlos
harrison	harrison
data	daten
prerequisites	voraussetzungen
ship	schiff
thread	faden
polnische	polnische
telephone	telefon
adults	erwachsene
nato	nato
potsdam	potsdam
specific	spezifisch
towards	towards
criticism	kritik
persecution	verfolgung
chapter	kapitel
streit	streit
fields	felder
luther	luther
widow	witwe
closer	closer
undo	rückgängig
charles	charles
muslims	muslims
kenya	kenya
bay	bucht
learned	gelernt
discussion	diskussion
laws	gesetze
lake	see
soft	weich
#efefef	#efefef
theodore	theodor
microsoft	microsoft
clay	lehm
christine	christine
sprint	sprint
excluded	ausgeschlossen
muslim	muslim
insel	island
lübeck	lübeck
revolutionary	revolutionär
strike	streik
island	insel
sister	schwester
category	kategorie
threatened	bedroht
hartmann	hartmann
fifteen	fünfzehn
army	armee
graz	graz
reported	berichtet
billions	milliarden
mining	bergbau
hollywood	hollywood
partner	partner
globe	globus
informed	informiert
loss	verlust
hospital	krankenhaus
double	doppelt
turkish	türkisch
academy	akademie
oil	öl
louisiana	louisiana
liberal	liberaler
transport	transport
here	hier
failed	gescheitert
jeff	jeff
iowa	iowa
how	wie
provided	bereitgestellt
kleine	kleine
portuguese	portugiesisch
investment	investition
nbc	nbc
parameters	parameters
autobahn	autobahn
type	typ
land	land
contra	contra
benjamin	benjamin
theory	theorie
baseball	baseball
charlotte	charlotte
table	tisch
towers	türme
golden	golden
influential	einflussreich
tourism	tourismus
existence	existenz
poly	poly
erforschung	erforschung
bomb	bombe
five	fünf
option	option
corps	korps
copy	kopie
org/wiki/	org/wiki/
taiwan	taiwan
vegas	vegas
guided	geleitet
besten	besten
ohio	ohio
noise	lärm
coalition	koalition
steps	schritte
pedro	pedro
played	gespielt
men	männer
protected	geschützt
choir	chor
football	fußball
pete	pete
chemical	chemisch
boston	boston
manga	manga
crime	verbrechen
apple	apfel
rudolf	rudolf
oldest	älteste
relegation	abstieg
cricketer	cricketspieler
eyes	augen
patrick	patrick
music	musik
mitchell	mitchell
cemetery	friedhof
resources	ressourcen
officers	offiziere
unification	vereinigung
evening	abend
campus	campus
aaron	aaron
composition	zusammensetzung
mecklenburg	mecklenburg
earthquake	erdbeben
dissemination	verbreitung
melbourne	melbourne
matt	matt
ideal	ideal
changed	verändert
president	präsident
temple	tempel
netherlands	niederlande
johnson	johnson
bound	gebunden
patients	patienten
cousin	cousin
organised	organisiert
spain	spanien
reader	leser
slave	sklave
frequency	häufigkeit
husband	ehemann
logo	logo
australian	australisch
ethnic	ethnisch
fountain	brunnen
austin	austin
midfielder	mittelfeldspieler
weekly	wöchentlich
milk	milch
decision	entscheidung
gordon	gordon
west	west
jens	jens
before	vorher
acoustic	akustisch
comparable	vergleichbar
matter	materie
critical	kritisch
gospel	evangelium
coffee	kaffee
united	vereinigt
seen	gesehen
aber	aber
committee	ausschuss
stockholm	stockholm
edinburgh	edinburgh
signature	unterschrift
logs	logs
guilty	schuldig
background	hintergrund
september	september
stat	stat
collective	kollektiv
white	weiß
apprenticeship	ausbildung
bachelor	junggeselle
leonard	leonard
acknowledged	anerkannt
literature	literatur
businessman	geschäftsmann
temperature	temperatur
stronger	stärker
improvements	verbesserungen
persian	persisch
elisabeth	elisabeth
membership	mitgliedschaft
christianity	christentum
far	weit
alaska	alaska
markets	märkte
insects	insekten
festschrift	festschrift
oxford	oxford
dj	dj
ältesten	ältesten
nevada	nevada
participant	teilnehmer
seconds	sekunden
real	real
services	dienste
comic	comic
lead	blei
strategic	strategisch
heinz	heinz
insurance	versicherung
financial	finanzielle
economics	volkswirtschaftslehre
colony	kolonie
orleans	orléans
hindu	hindu
countess	gräfin
medical	medizinisch
rugby	rugby
judge	richter
lincoln	lincoln
research	forschung
stark	stark
nigeria	nigeria
luck	glück
legs	beine
coast	küste
exhibition	ausstellung
worldwide	weltweit
matthias	matthias
duties	pflichten
gebiete	gebiete
machinery	maschinen
fernsehen	fernsehen
economy	ökonomie
fire	feuer
your	dein
principles	prinzipien
arbitration	schiedsverfahren
jews	juden
variable	variabel
andreas	andreas
zeitschrift	zeitschrift
american	amerikanisch
written	geschrieben
factors	faktoren
doctors	ärzte
robinson	robinson
regional	regional
route	route
beziehungen	beziehungen
russian	russisch
communication	kommunikation
harbor	hafen
lat	lat
upbringing	erziehung
successful	erfolgreich
alcohol	alkohol
tram	straßenbahn
november	november
folge	folge
discipline	disziplin
pages	seiten
solutions	lösungen
larry	larry
short	kurz
museums	museen
compilation	kompilation
kings	könige
coerced	gezwungen
secured	gesichert
brandenburg	brandenburg
love	liebe
structure	struktur
jerry	jerry
gold	gold
utah	utah
fans	fans
iranian	iranisch
inc	inc
rolf	rolf
gemeinden	gemeinden
poverty	armut
jobs	jobs
ferdinand	ferdinand
cross	kreuz
sometimes	manchmal
figure	figur
madrid	madrid
hoffmann	hoffmann
law,	gesetz
romania	rumänien
instrument	instrument
maximum	maximum
contributed	beigetragen
wins	gewinnt
post	post
tritt	tritt
caught	eingefangen
cleveland	cleveland
thompson	thompson
documentary	dokumentarfilm
discovery	entdeckung
maria	maria
wagner	wagner
korean	koreanisch
lion	löwe
ships	schiffe
structures	strukturen
frame	rahmen
thai	thai
accused	angeklagt
significant	signifikant
fairly	fairly
architect	architekt
southwest	südwesten
different	verschieden
cool	kühl
sport	sport
recommended	empfohlen
rogers	rogers
forschungen	forschungen
jh	jh
cells	zellen
historical	historisch
fruit	frucht
adelaide	adelaide
tübingen	tübingen
abschnitt	abschnitt
search	suche
must	müssen
part	teil
defender	verteidiger
bmw	bmw
jena	jena
opposed	entgegengesetzt
erwin	erwin
golf	golf
thin	dünn
inhabitant	bewohner
greek	griechisch
trivial	trivial
bamberg	bamberg
belt	gürtel
yorkshire	yorkshire
julia	julia
experience	erfahrung
sierra	sierra
property	eigentum
exception	ausnahme
body	körper
silver	silber
treatment	behandlung
tube	röhre
scoring	scoring
thu	thu
karlsruhe	karlsruhe
liberation	befreiung
milan	milan
shadow	schatten
nassau	nassau
second	zweiter
pope	papst
percussion	perkussion
drugs	drogen
affairs	angelegenheiten
traditional	traditionell
serbia	serbien
blood	blut
sponsored	gesponsert
moscow	moskau
movements	bewegungen
seasons	jahreszeiten
formulated	formuliert
marco	marco
increasingly	zunehmend
brunswick	braunschweig
gothic	gotisch
florian	florian
collections	sammlungen
architects	architekten
intended	beabsichtigt
ten	zehn
vandalism	vandalismus
documents	dokumente
acknowledgment	anerkennung
extremely	äußerst
arm	arm
danish	dänisch
river	fluss
derby	derby
blätter	blätter
anmerkungen	anmerkungen
campaign	kampagne
plans	pläne
military	militärisch
somewhere	irgendwo
greece	griechenland
again,	wieder
battalion	bataillon
aachen	aachen
wunsch	wunsch
program	programm
extinct	ausgestorben
collins	collins
bird	vogel
abstention	abstimmung
processes	prozesse
technologies	technologien
opportunity	gelegenheit
producer	produzent
immigration	einwanderung
grande	grande
edwards	edwards
state	staat
tanks	tanks
organisation	organisation
advanced	fortgeschritten
against	gegen
wuppertal	wuppertal
fish	fisch
cardinal	kardinal
tables	tische
internationalen	internationalen
andy	andy
not	nicht
publication	veröffentlichung
officially	offiziell
blog	blog
brussels	brüssel
france	frankreich
austria	österreich
cash	bargeld
mal	mal
denmark	dänemark
roland	roland
alps	alpen
eva	eva
designed	entworfen
knot	knoten
coi	coi
january	januar
agreement	übereinkunft
fisherman	fischer
yes	ja
territorial	territoriale
york	york
representation	repräsentation
corporation	korporation
set	gesetzt
morgan	morgan
pioneer	pionier
susan	susan
experiment	experiment
truck	lkw
southeast	südosten
göttingen	göttingen
intellectual	intellektuell
quellen	quellen
logic	logik
talks	talks
stephan	stephan
attentiveness	aufmerksamkeit
submarine	unterseeboot
four	vier
parish	pfarrei
instrumental	instrumental
shah	shah
sickness	krankheit
stadium	stadion
julius	julius
central	zentral
les	les
tamil	tamil
carrier	träger
file	datei
hannover	hannover
terry	terry
cycle	zyklus
nuremberg	nürnberg
concentration	konzentration
universe	universum
luftwaffe	luftwaffe
hall	halle
infobox	infobox
authors	autoren
family	familie
overview	überblick
kleinen	kleinen
amerikanische	amerikanische
now	jetzt
houses	häuser
breisgau	breisgau
bank	bank
maximilian	maximilian
forward	vorwärts
canada	kanada
mainz	mainz
situation	situation
heath	heide
idea	idee
importance	wichtigkeit
shanghai	shanghai
asp	asp
egypt	ägypten
rd	rd
teacher	lehrer
extreme	extremer
valign	valign
landing	landung
hamilton	hamilton
agency	agentur
motors	motoren
dissertation	dissertation
kiel	kiel
students	studierende
agricultural	agricultural
sons	söhne
northern	nördlich
sweet	süß
map	karte
angel	engel
publications	veröffentlichungen
jefferson	jefferson
monthly	monatlich
worse	schlimmer
platforms	plattformen
audio	audio
herbert	herbert
guinea	guinea
consecrated	geweiht
osnabrück	osnabrück
peoples	völker
louis	louis
sebastian	sebastian
murder	mord
yugoslavia	jugoslawien
neuzeit	neuzeit
heaven	himmel
coach	coach
locomotives	lokomotiven
sleep	schlaf
volume	volumen
norwegian	norwegisch
tip	tipp
relevance	relevanz
introduction	einführung
nuclear	nuklear
dauer	dauer
anime	anime
continental	kontinental
foot	fuß
toronto	toronto
long	lang
raymond	raymond
editorial	redaktionell
success	erfolg
hessen	hessen
citation	zitierung
download	herunterladen
unincorporated	unincorporated
ard	ard
vancouver	vancouver
sed	sed
queensland	queensland
oskar	oskar
eruption	ausbruch
nie	nie
carlos	carlos
region	region
paul	paul
panel	panel
hunter	jäger
banks	banken
ottawa	ottawa
saturday	samstag
heroes	helden
trees	bäume
conscience	gewissen
autonomous	autonome
copenhagen	kopenhagen
adams	adams
composer	komponist
expensive	teuer
venezuela	venezuela
beam	balken
argumentation	argumentation
examples	beispiele
regierungsbezirk	regierungsbezirk
useful	nützlich
vorpommern	vorpommern
house	haus
defense	verteidigung
identity	identität
manager	manager
horror	horror
palestinian	palästinensisch
rescue	rettung
king	könig
dissolution	auflösung
bengal	bengal
information	information
territory	territorium
playtime	spielzeit
tribute	tribut
streets	strassen
becker	becker
commented	kommentiert
paid	bezahlt
clinical	klinisch
blind	blinde
governors	gouverneure
summit	gipfel
fifa	fifa
provinces	provinzen
buffalo	büffel
conductor	dirigent
seal	siegel
birthday	geburtstag
eberhard	eberhard
racing	rennsport
passengers	passagiere
damaged	beschädigt
conclusion	schluss
encyclopedic	enzyklopädisch
leopold	leopold
blues	blues
baby	baby
senators	senatoren
franchise	franchise
support	unterstützung
open	offen
anonymous	anonym
lothar	lothar
photographs	fotografien
tennessee	tennessee
paris	paris
words	wörter
roof	dach
protest	protest
duisburg	duisburg
hudson	hudson
crystal	kristall
knight	ritter
sections	abschnitte
johannes	johannes
hughes	hughes
copper	kupfer
new	neu
dreams	träume
romantic	romantisch
jane	jane
filled	gefüllt
interviews	interviews
objective	objektiv
santa	santa
clothing	kleidung
bought	gekauft
parliament	parlament
african	afrikanisch
director	regisseur
nominated	nominiert
zug	zug
artist	künstler
portal	portal
theories	theorien
boote	boote
ian	ian
murray	murray
active	aktiv
png	png
james	james
steven	steven
offer	angebot
reception	empfang
giant	riese
michael	michael
philosophy	philosophie
litre	liter
broadway	broadway
ausgabe	ausgabe
jesus	jesus
bangladesh	bangladesch
marie	marie
null	null
ranking	rangliste
rose	rose
atlanta	atlanta
vehicles	fahrzeuge
mobile	mobile
census	volkszählung
neil	neil
vessels	gefäße
oberbürgermeister	oberbürgermeister
oberliga	oberliga
foundation	stiftung
dietrich	dietrich
palestine	palästina
monument	denkmal
lip	lippe
difficulties	schwierigkeiten
israel	israel
adam	adam
steel	stahl
leaf	blatt
higher	höher
detroit	detroit
implemented	umgesetzt
renaming	umbenennung
persecuted	verfolgt
also	auch
anderson	anderson
challenge	herausforderung
poetry	poesie
photos	fotos
athens	athen
motor	motor
parks	parks
camera	kamera
sultan	sultan
lines	linien
village	dorf
personalities	persönlichkeiten
carlo	carlo
band	bande
wolf	wolf
purple	purpurn
categories	kategorien
coastal	küstenland
barcelona	barcelona
historian	historiker
field	feld
muhammad	muhammad
duo	duo
nature	natur
welcome	willkommen
theologian	theologe
infrastructure	infrastruktur
wine	wein
schwarze	schwarze
dortmund	dortmund
group	gruppe
planned	geplant
opposition	opposition
requirements	anforderungen
bulgaria	bulgarien
bobby	bobby
sämtliche	sämtliche
internet	internet
massachusetts	massachusetts
legend	legende
forum	forum
csu	csu
feast	fest
chairman	vorsitzender
\frac	\frac
italian	italienisch
true,	wahr
abu	abu
wife	ehefrau
portrait	porträt
strength	stärke
engineers	ingenieure
behalf	behalf
ukrainian	ukrainisch
minnesota	minnesota
maximal	maximal
buenos	buenos
along	entlang
determined	bestimmt
vermont	vermont
façade	fassade
leipzig	leipzig
alabama	alabama
integration	integration
national	national
species	spezies
ceo	ceo
platte	platte
during	während
brothers	brüder
adult	erwachsener
japan	japan
light	licht
wallace	wallace
breakthrough	durchbruch
bbc	bbc
endemic	endemisch
diplomat	diplomat
church	kirche
judgement	urteil
politician	politiker
alumni	alumni
mexico	mexiko
god	gott
creative	schöpferisch
honorary	ehrendoktor
requirement	anforderung
nonsense	unsinn
kommandeur	kommandeur
designer	designer
ehrlich	ehrlich
guy	guy
back	rücken
international	international
linux	linux
segment	segment
false	falsch
städte	städte
nachrichten	nachrichten
guitarist	gitarrist
ball	ball
variant	variante
norman	norman
bow	bogen
playoffs	playoffs
guitars	gitarren
christus	christus
schwarzen	schwarzen
sheffield	sheffield
glass	glas
references	referenzen
clerk	klerk
jimmy	jimmy
dm	dm
club	club
serbian	serbisch
blp	blp
lieber	lieber
helen	helen
inside	innen
kennedy	kennedy
young	jung
formal	formell
heart	herz
wooden	hölzern
color	farbe
cabinet	kabinett
oberst	oberst
doch	doch
german	german
philippine	philippinisch
parents	eltern
edward	edward
tours	tours
electricity	elektrizität
married	verheiratet
engineer	ingenieur
wisconsin	wisconsin
maryland	maryland
children	kinder
underside	unterseite
allegedly	angeblich
mouth	mund
prince	prinz
eighth	achte
knapp	knapp
düsseldorf	düsseldorf
hectare	hektar
objects	gegenstände
ran	ran
hardware	hardware
stage	bühne
driven	getrieben
elf	elf
quotation	zitat
conflict	konflikt
born	geboren
senator	senator
albrecht	albrecht
numerous	zahlreich
correct	korrekt
josé	josé
traditions	traditionen
dallas	dallas
seattle	seattle
benedict	benedikt
rabbi	rabbiner
wittenberg	wittenberg
arrangement	arrangement
funds	funds
richard	richard
expert	experte
colleagues	kollegen
tokyo	tokyo
soap	seife
suit	anzug
cofounder	mitbegründer
technology	technik
siege	belagerung
diameter	durchmesser
after	nach
ämter	ämter
agents	agenten
africa	afrika
context	kontext
actors	akteure
trophy	trophäe
oblast	oblast
broadcasting	broadcasting
battery	batterie
dogs	hunde
prussia	preußen
friendship	freundschaft
auf	auf
recognisable	erkennbar
roberts	roberts
auckland	auckland
community	gemeinschaft
mathematical	mathematisch
leipziger	leipziger
conquest	eroberung
patent	patent
legitimate	legitim
jim	jim
without	ohne
governments	regierungen
unclear	unklar
pennsylvania	pennsylvania
home	heim
exhibitions	ausstellungen
screenplay	drehbuch
sole	sole
dated	datiert
weapon	waffe
friend	freund
archaeology	archäologie
exile	exil
workshop	werkstatt
priest	priester
gov	gov
global	global
stimmen	stimmen
canal	kanal
abitur	abitur
dvd	dvd
format	format
statistics	statistik
dublin	dublin
cbs	cbs
dresden	dresden
antarctic	antarktis
meines	meines
measures	maße
celebrated	gefeiert
rechristened	umbenannt
troops	truppen
spectator	zuschauer
continued	fortgesetzt
org/w/index	org/w/index
dich	dich
pakistan	pakistan
christopher	christopher
constitution	verfassung
einheit	einheit
bonn	bonn
unconditionally	unbedingt
steam	dampf
chair	stuhl
heinrich	heinrich
elevation	erhebung
elevated	erhöht
critic	kritiker
cold	kalt
modern	modern
stones	steine
democrats	demokraten
manufacturing	fertigung
buddhist	buddhist
art	kunst
academic	akademisch
radio	radio
republic	republik
representative	repräsentant
tiger	tiger
directors	direktoren
medicine	medizin
diplomatic	diplomatisch
duchy	herzogtum
rené	rené
out	aus
supported	unterstützt
operator	operator
organ	orgel
reiner	reiner
believes	glaubt
candidate	kandidat
settlements	ansiedlungen
rain	regen
accepted	akzeptiert
necessary	notwendig
syndrome	syndrom
hms	hms
finland	finnland
measured	gemessen
discovered	entdeckt
farmers	landwirte
phil	phil
%	%
alice	alice
birds	vögel
politics	politik
arts	künste
bible	bibel
quality	qualität
juniors	junioren
injuries	verletzungen
schneller	schneller
braun	braun
authority	autorität
schwerin	schwerin
fourth	vierter
egyptian	ägyptisch
marburg	marburg
minister	minister
genre	genre
guideline	richtlinie
specialized	spezialisiert
conrad	konrad
street	straße
alpha	alpha
kpd	kpd
fulfilled	erfüllt
mill	mühle
views	ansichten
malaysia	malaysia
interview	interview
negative	negativ
window	fenster
nepal	nepal
brooklyn	brooklyn
steve	steve
peter	peter
europe	europa
brewery	brauerei
occupation	besetzung
germany	deutschland
leading	führend
philosopher	philosoph
grafen	grafen
two	zwei
twelve	zwölf
inner	inneres
madison	madison
poems	gedichte
reservoir	reservoir
republican	republikaner
florida	florida
criminal	verbrecher
superfluous	überflüssig
nr	nr
generation	generation
feet	füße
walls	wände
schade	schade
horse	pferd
grandfather	großvater
editwar	editwar
%/	%/
taken	genommen
josef	josef
iran	iran
rostock	rostock
pearl	perle
garden	garten
quite	quite
thomas	thomas
hundreds	hunderte
integrated	integriert
bruce	bruce
mac	mac
alfred	alfred
hard	hart
overseas	overseas
auflage	auflage
magic	zauberkunst
medals	medaillen
cooperation	zusammenarbeit
sankt	sankt
player	spieler
salzburg	salzburg
societies	gesellschaften
mile	meile
cats	katzen
unbeknownst	unbekannt
psychology	psychologie
instead	stattdessen
ips	ips
typical	typisch
ladies	damen
jacques	jacques
cavalry	kavallerie
meyer	meyer
direction	richtungsangabe
linz	linz
reste	reste
bronze	bronze
yesterday	gestern
abteilung	abteilung
oklahoma	oklahoma
deck	deck
variants	varianten
tank	panzer
oldenburg	oldenburg
cause	ursache
delaware	delaware
guidelines	richtlinien
fulda	fulda
actor	schauspieler
conditions	bedingungen
together	zusammen
austrian	österreichisch
lordship	herrschaft
profile	profil
chemistry	chemie
harvey	harvey
assistant	assistent
density	dichte
counties	landkreise
effective	effektiv
zog	zog
participation	beteiligung
städtische	städtische
asking	asking
commercial	kommerziell
attentive	aufmerksam
münchner	münchner
rock	fels
cologne	köln
adequate	ausreichend
um	um
familiar	vertraut
visit	besuch
admiral	admiral
behaviour	verhalten
indoor	indoor
conference	konferenz
abbreviation	abkürzung
realised	realisiert
facts	tatsachen
jacob	jacob
friends	freunde
observed	beobachtet
round	runde
frankfurter	frankfurter
increase	zunahme
principally	hauptsächlich
equivalent	äquivalent
idaho	idaho
inspired	inspiriert
painter	maler
vehicle	fahrzeug
darmstadt	darmstadt
hauptmann	hauptmann
various	verschiedene
operations	operationen
influences	einflüsse
google	google
colors	farben
festival	festival
wand	wand
perspective	perspektive
happens	geschieht
center	zentrum
russell	russell
uns	uns
wars	kriege
resigned	resigniert
gap	lücke
activist	aktivist
eddie	eddie
anti	anti
ireland	irland
victory	sieg
british	britisch
decided	entschieden
pittsburgh	pittsburgh
kick	kick
url	url
bar	bar
key	schlüssel
organic	organisch
dargestellt	dargestellt
lawrence	lawrence
plant	pflanze
festivals	festivals
communities	gemeinschaften
made	gemacht
convention	konvention
relevant	relevant
peer	peer
philippe	philippe
debut	debut
portrayed	porträtiert
posted	gepostet
singh	singh
investigations	untersuchungen
rooster	hahn
mache	mache
uprising	aufstand
page	seite
kreis	kreis
front	vorderseite
davor	davor
friendly	freundlich
exit	ausgang
individual	individuum
minutes	minuten
diamond	diamant
asia	asien
old	alt
mechanical	mechanisch
answer	antwort
cricket	cricket
straight	gerade
gas	gas
ottoman	ottoman
platform	plattform
joint	gelenk
hindi	hindi
earth	erde
industrial	industriell
mediterranean	mediterran
automatic	automatik
manfred	manfred
chamber	kammer
walther	walther
university	universität
world,	welt
poster	plakat
volunteer	freiwilliger
letter	buchstabe
physicist	physiker
interaction	interaktion
naturally	natürlich
westphalia	westfalen
six	sechs
colonial	kolonial
supporting	unterstützend
establishment	establishment
english	englisch
beijing	beijing
todd	todd
sitting	sitzung
nachweis	nachweis
regensburg	regensburg
league	liga
sciences	wissenschaften
prefecture	präfektur
virtual	virtuell
said	gesagt
ideas	ideen
painted	gemalt
andrea	andrea
racial	rassisch
comprehensive	umfassend
slovakia	slowakei
april	april
dam	talsperre
server	server
aufstieg	aufstieg
ontario	ontario
net	netz
uefa	uefa
irish	irisch
arena	arena
trier	trier
team	team
arrondissement	arrondissement
lays	legt
reason	vernunft
height	höhe
freiburg	freiburg
august	august
holstein	holstein
iraq	irak
ps	ps
better	besser
stretches	strecken
channels	kanäle
absolute	absolut
alan	alan
hoher	hoher
heim	home
girl	mädchen
switzerland	schweiz
retirement	ruhestand
adolf	adolf
very	sehr
trinity	dreifaltigkeit
reaction	reaktion
satellite	satellit
cathedral	kathedrale
inclusion	inklusion
should	sollte
gustav	gustav
thoughts	gedanken
johanna	johanna
reform	reform
monday	montag
blue	blau
consensus	konsens
catholic	katholisch
svg	svg
sold	verkauft
weather	wetter
wikiproject	wikiprojekt
seed	saatgut
ddr	ddr
latino	latino
jay	jay
silesia	schlesien
many	viele
spent	verbracht
dna	dna
ivan	ivan
arthur	arthur
possibilities	möglichkeiten
pokal	pokal
cincinnati	cincinnati
asteroid	asteroid
dramatic	dramatisch
autumn	herbst
several	several
gauge	gauge
anhalt	anhalt
alberta	alberta
three	drei
bis	bis
alternative	alternativ
miami	miami
southeasterly	südöstlich
courts	gerichtshöfe
those	diejenigen
soviet	sowjet
texas	texas
bremen	bremen
growth	wachstum
concretely	konkret
special	speziell
losses	verluste
mars	mars
last	letzter
annually	jährlich
loud	laut
aufbau	aufbau
wilhelm	wilhelm
trio	trio
application	bewerbung
symphony	symphonie
storm	sturm
documented	dokumentiert
leftover	übrig
lewis	lewis
fred	fred
california	kalifornien
baron	baron
hg	hg
action	aktion
kentucky	kentucky
azerbaijan	azerbaijan
rhythm	rhythmus
mathematics	mathematik
gregor	gregor
mannheim	mannheim
wind	wind
production	produktion
paar	paar
criteria	kriterien
disney	disney
peace	frieden
youngest	jüngster
franz	franz
kommando	kommando
duke	herzog
heir	erbe
lgbt	lgbt
baltimore	baltimore
euro	euro
sharp	scharf
steady	ständig
palace	palast
eagle	adler
improved	verbessert
negotiations	verhandlungen
palatinate	pfalz
istanbul	istanbul
appeal	appell
graham	graham
yale	yale
favorite	favorit
therapy	therapie
former	former
atlantic	atlantisch
lawyers	rechtsanwälte
altes	altes
journalist	journalist
tunnel	tunnel
bob	bob
system	system
phoenix	phönix
right	rechts
weil	weil
kilometer	kilometer
peninsula	halbinsel
entertainment	unterhaltung
usa	usa
conferred	verliehen
rhine	rhein
manchester	manchester
crisis	krisis
hawaii	hawaii
datum	datum
louise	louise
remembrance	erinnerung
wayne	wayne
katharina	katharina
nomination	nominierung
naja	naja
connection	verbindung
comedy	komödie
expression	ausdruck
ring	ring
wiener	wiener
federal	bundesrepublik
turin	turin
match	match
stripe	streifen
ab	ab
hermann	hermann
impossible	unmöglich
mathematician	mathematiker
archiving	archivierung
remote	fernbedienung
rector	rektor
voice	stimme
regulated	geregelt
saxony	sachsen
massive	massiv
february	februar
hands	hände
anxiety	angst
no	nein
habitat	habitat
quarterfinals	viertelfinale
turnover	umsatz
religion	religion
gallery	galerie
neighborhood	nachbarschaft
flat	flat
biology	biologie
heights	höhen
dog	hund
manhattan	manhattan
briefs	briefe
settlement	ansiedlung
regie	regie
management	management
manufacturer	hersteller
valid	gültig
products	produkte
killed,	getötet
atlas	atlas
fly	fliege
connecticut	connecticut
semifinal	halbfinale
province	provinz
head	kopf
hand	hand
instruments	instrumente
nelson	nelson
bielefeld	bielefeld
schwarz	schwarz
him	ihn
experiences	erlebnisse
interests	interessen
edits	edits
agriculture	landwirtschaft
rfc	rfc
devastation	zerstörung
anna	anna
presentation	präsentation
ski	ski
chain	kette
gone	gegangen
change	veränderung
door	tür
people,	volk
overworked	überarbeitet
depictions	darstellungen
caribbean	karibik
cable	kabel
established	etabliert
byzantine	byzantinisch
nearly	nearly
presidents	präsidenten
luxembourg	luxemburg
oak	eiche
htm	htm
volleyball	volleyball
photo	foto
tennis	tennis
sophie	sophie
sunday	sonntag
tower	turm
gross	gross
mach	mach
union	union
entries	einträge
including	einschließlich
announced	angekündigt
books	bücher
dennis	dennis
inappropriate	unangemessen
clan	clan
gottfried	gottfried
bristol	bristol
schlechter	schlechter
suspended	suspended
status	status
opponent	gegner
blocks	blöcke
period	periode
record	rekord
thuringia	thüringen
williams	williams
weimar	weimar
gerät	gerät
chinese	chinesisch
centimetre	zentimeter
eight	acht
bishops	bischöfe
registered	eingetragen
interface	schnittstelle
held	gehalten
instructions	anweisungen
way,	weg
runs	läuft
singapore	singapur
armenian	armenisch
childhood	kindheit
qualification	qualifikation
literary	literarisch
mini	mini
kent	kent
interstate	interstate
oakland	oakland
morning	morgen
comments	kommentare
vietnam	vietnam
facility	facility
political	politisch
menge	menge
possession	besitz
lemma	lemma
stem	stamm
capital	kapital
harold	harold
kingdom	königreich
animation	animation
dieter	dieter
parameter	parameter
charter	charter
schneider	schneider
been	been
kader	kader
heidelberg	heidelberg
foundations	grundlagen
wished	gewünscht
alliance	allianz
horst	horst
hook	haken
virginia	virginia
detailed	detailliert
synagogue	synagoge
book	buch
physics	physik
cellar	keller
wild	wild
printed	gedruckt
daughters	töchter
delta	delta
senate	senat
institute	institut
fiction	fiktion
eastern	östlich
northeasterly	nordöstlich
competition	konkurrenz
jackson	jackson
deal	deal
independence	unabhängigkeit
id	id
romanian	rumänisch
tour	tour
neckar	neckar
yellow	gelb
cinema	kino
personal	persönlich
ministry	ministerium
america	amerika
myself	myself
harry	harry
theater	theater
poet	dichter
modified	modifiziert
either	entweder
user	benutzer
adaptation	anpassung
parallel	parallele
planning	planung
montana	montana
millimetre	millimeter
things	dinge
controlled	kontrolliert
changes	veränderungen
withdrawn	zurückgezogen
hurricane	hurrikan
miller	müller
airplanes	flugzeuge
secondary	sekundär
depression	depression
internationaler	internationaler
pitcher	pitcher
jurist	jurist
chairwoman	vorsitzende
armed	bewaffnet
hotel	hotel
sixth	sechst
joan	joan
bundesliga	bundesliga
laboratory	laboratorium
hell	hölle
opening	eröffnung
jg	jg
carinthia	kärnten
water	wasser
london	london
sale	verkauf
primary	primär
gabriel	gabriel
master	meister
interest	interesse
budapest	budapest
broken	gebrochen
unusual	ungewöhnlich
calendar	kalender
forbidden	verboten
douglas	douglas
weak	schwach
tut	tut
neutral	neutral
croatian	kroatisch
praxis	praxis
perfect	perfekt
conservative	konservativ
archived	archiviert
allgemeinen	allgemeinen
carolina	carolina
clock	uhr
paderborn	paderborn
bist	bist
mitteleuropa	mitteleuropa
wilson	wilson
title	titel
donald	donald
lee	lee
bat	fledermaus
popularity	beliebtheit
bass	bass
mixed	gemischt
ruin	ruine
milwaukee	milwaukee
energy	energie
dame	dame
press	presse
formerly	vormals
temporary	vorübergehend
delivered	geliefert
sony	sony
ambassador	botschafter
stuttgart	stuttgart
activities	aktivitäten
toward	toward
thousand	tausend
women	frauen
paulo	paulo
greetings	grüße
delhi	delhi
sg	sg
genera	gattungen
these	diese
experienced	erlebt
paper	papier
tool	werkzeug
mechanism	mechanismus
bands	bands
present	präsent
kelly	kelly
competitors	konkurrenten
concept	konzept
anders	anders
successes	erfolge
arabic	arabisch
tree	baum
congress	kongreß
sector	sektor
where	wohin
cambridge	cambridge
offered	angeboten
philipp	philipp
individuals	individuen
bernhard	bernhard
consistent	konsistent
district	bezirk
miles	meilen
königsberg	königsberg
schönen	schönen
hungarian	ungarisch
movement	bewegung
restoration	wiederherstellung
ceremony	zeremonie
illinois	illinois
finnish	finnisch
reports	berichte
colorado	colorado
handbook	handbuch
beziehung	beziehung
japanese	japanisch
blogspot	blogspot
oper	oper
good	gut
simultaneously	gleichzeitig
hamburger	hamburger
ice	eis
lisa	lisa
philip	philip
database	datenbank
graphic	graphisch
evans	evans
antonio	antonio
phillips	phillips
david	david
queen	königin
sword	schwert
administration	verwaltung
obama	obama
condition	bedingung
contrast	kontrast
reformation	reformation
somerset	somerset
kaiser	kaiser
englische	englische
são	são
diesel	dieselmotor
günther	günther
places	plätze
victoria	victoria
character	charakter
hospitals	krankenhäuser
pain	schmerz
daher	daher
frank	frank
creation	schöpfung
lust	lust
sydney	sydney
western	westlich
so	so
principle	grundsatz
vs	vs
jürgen	jürgen
climate	klima
next	nächste
personality	persönlichkeit
clemens	clemens
zone	zone
metal	metall
israeli	israelisch
frankfurt	frankfurt
pseudonym	pseudonym
contributions	beiträge
erik	erik
substantial	substantiell
fishing	fischfang
schleswig	schleswig
controversial	controversial
function	funktion
princess	prinzessin
harvard	harvard
ocean	ozean
wounded	verwundet
walker	spaziergänger
forty	vierzig
city	stadt
applied	angewandt
mines	minen
our	unser
wellington	wellington
koblenz	koblenz
cost	kosten
gardens	gärten
available	verfügbar
tigers	tigers
illustrated	illustriert
stone	stein
übersetzung	übersetzung
wood	holz
artillery	artillerie
civilian	zivilist
sarah	sarah
stanley	stanley
default	default
combined	kombiniert
willy	willy
brief	brief
carbon	kohlenstoff
religious	religiös
fix	fix
metropolitan	metropolitan
michel	michel
stars	sterne
rifle	gewehr
ansatz	ansatz
decade	jahrzehnt
records	rekorde
painting	malerei
concerning	concerning
khan	khan
maurice	maurice
portugal	portugal
dollar	dollar
flight	flucht
regularly	regelmäßig
court	gerichtshof
ferry	fähre
december	dezember
cat	katze
werner	werner
editors	redakteure
details	details
wolfgang	wolfgang
anne	anne
jpg	jpg
ukraine	ukraine
quasi	quasi
diego	diego
product	produkt
themes	themen
midpoint	mittelpunkt
governor	gouverneur
reed	schilf
return	rückkehr
when	wann
nothing	nichts
billion	milliarde
perception	wahrnehmung
orthodox	orthodox
diocese	diözese
number	nummer
characters	charaktere
berkeley	berkeley
daughter	tochter
analysis	analyse
kleiner	kleiner
airplane	flugzeug
southern	südlich
laura	laura
actress	schauspielerin
belgian	belgisch
photographer	photographer
credit	kredit
situated	situiert
parliamentary	parlamentarisch
nonetheless	dennoch
erich	erich
amsterdam	amsterdam
conventional	konventionell
operation	operation
dakota	dakota
abbot	abt
responsibility	verantwortung
through	durch
calculated	berechnet
journals	journals
promoted	befördert
internationales	internationales
subjects	subjects
theology	theologie
first	zuerst
software	software
norbert	norbert
professorship	professur
birth	geburt
tools	werkzeuge
leider	leider
names	namen
columbus	columbus
development	entwickelung
sugar	zucker
signal	signal
sexual	sexuell
heilbronn	heilbronn
sought	gesucht
venice	venedig
subdivided	unterteilt
synonym	synonym
credits	kredite
coal	steinkohle
territories	territorien
scale	skala
index	index
everyone,	jeder
mastership	meisterschaft
ordered	bestellt
wagon	wagen
bowling	bowling
normal	normal
experimental	experimentell
scientist	wissenschaftler
wikimedia	wikimedia
producers	produzenten
contacts	kontakte
england	england
school	schule
griechischen	griechischen
gottes	gottes
yearbook	jahrbuch
johann	johann
afghanistan	afghanistan
industry	industrie
ladder	leiter
joachim	joachim
youtube	youtube
sight	sicht
mirror	spiegel
hot	heiß
hc	hc
reinhard	reinhard
uncle	onkel
audience	publikum
cinemas	kinos
mercedes	mercedes
virus	virus
ludwig	ludwig
underneath	unten
switch	schalter
input	eingabe
defensive	defensiv
lp	lp
points	punkte
decisions	entscheidungen
kassel	kassel
year	jahr
cap	mütze
airport	flughafen
chicago	chicago
symbol	symbol
berlin	berlin
corner	ecke
alex	alex
lorenz	lorenz
opinions	meinungen
died	gestorben
voivodeship	woiwodschaft
wehrmacht	wehrmacht
novelist	romancier
autoconfirmed	autoconfirmed
elite	elite
licensed	lizenziert
socorro	socorro
regiment	regiment
practical	praktisch
recipient	empfänger
hoax	hoax
jason	jason
hour	stunde
manufacturers	manufacturers
drama	drama
premiere	premiere
glasgow	glasgow
joe	joe
clergyman	geistlicher
breaking	breaking
tradition	tradition
anglican	anglikanisch
bishop	bischof
doctor	doktor
verzeichnis	verzeichnis
victorian	victorian
avenue	avenue
range	reichweite
syria	syrien
classical	klassisch
westen	westen
breslau	breslau
catalogue	katalog
campaigns	kampagnen
fifty	fünfzig
watson	watson
we	wir
warning	warnung
factor	faktor
billy	billy
emergency	notfall
salt	salz
war	krieg
partnership	partnerschaft
rebellion	rebellion
entire	entire
siegfried	siegfried
modify	modifizieren
regions	regionen
style	stil
south	süden
soul	seele
accessible	zugänglich
recent	recent
henri	henri
job	job
pomerania	pommern
beer	bier
ballet	ballett
classification	klassifikation
suburb	vorort
appraisal	bewertung
eyeball	auge
unrestricted	unbeschränkt
murphy	murphy
fortress	festung
stanford	stanford
interested	interessiert
driver	fahrer
corporate	corporate
drummer	trommler
studies	studien
snow	schnee
electrical	elektrisch
accident	unfall
mythology	mythologie
hugh	hugh
tourist	tourist
fine	fein
film	film
text	text
singles	singles
wave	welle
bytes	bytes
lighter	leichter
pop	popmusik
entstehung	entstehung
grafschaft	grafschaft
wales	wales
detail	detail
quantum	quantum
flood	flut
applications	anträge
outstanding	hervorragend
aspects	aspekte
entrepreneur	unternehmer
conflicts	konflikte
positive	positiv
frederick	frederick
