london	londres
alliance	alliance
intelligence	intelligence
jay	geai
newton	newton
april	avril
palestinian	palestinien
municipalities	municipalités
ladder	échelle
sophie	sophie
louvre	louvre
purpose	purpose
oklahoma	oklahoma
over	over
searching	searching
painter	peintre
observation	observation
mario	mario
singh	singh
toward	toward
act,	acte
chronicle	chronique
division	division
francesco	francesco
popular	populaire
usa	usa
tree	arbre
popularity	popularité
arbitrage	arbitrage
clear	clair
super	super
exile	exil
alimentary	alimentaire
flower	fleur
archipelago	archipel
calais	calais
sister	soeur
leaving	leaving
joseph	joseph
consequence	conséquence
couple	couple
vestiges	vestiges
cause	cause
territory	territoire
iran	iran
engaged	engagé
incidents	incidents
records	records
gérard	gérard
recipient	récipiendaire
modification	modification
debit	débit
agency	agence
eagle	aigle
environmental	environnemental
romania	roumanie
adult	adulte
adjacent	adjacent
opportunities	opportunités
tu	tu
tibet	tibet
actors	acteurs
table	table
typical	typique
drew	drew
kerala	kerala
canada	canada
motif	motif
hungarian	hongrois
rouen	rouen
nelson	nelson
puy	puy
jefferson	jefferson
petit	petit
basilica	basilique
click	clic
lisbon	lisbonne
samuel	samuel
tube	tube
yale	yale
coupe	coupe
chain	chaîne
positions	positions
available	disponible
montpellier	montpellier
alumni	alumni
fernando	fernando
confederation	confédération
creator	créateur
never	never
albert	albert
settlements	settlements
maurice	maurice
parents	parents
library	bibliothèque
account	compte
confused	confus
mot	mot
%a	%a
historian	historien
cleveland	cleveland
locally	localement
jackson	jackson
possibility	possibilité
villeneuve	villeneuve
victoire	victoire
experiences	expériences
school,	école
nouveaux	nouveaux
rhythm	rythme
discoveries	découvertes
bachelor	célibataire
annually	annuellement
bone	os
international	international
regardless	regardless
readers	lecteurs
attractions	attractions
attention	attention
olive	olivier
demographic	démographique
flandre	flandre
educated	éduqué
contes	contes
crime	crime
dj	dj
five	cinq
parish	paroisse
too	too
#efefef	#efefef
mandate	mandat
exterior	extérieur
anywhere	anywhere
options	options
singers	chanteurs
glasgow	glasgow
terre	terre
swedish	suédois
decided	décidé
dreams	rêves
threatened	threatened
russell	russell
valuable	valuable
dordogne	dordogne
birmingham	birmingham
actress	actrice
sectors	secteurs
vq	vq
offensive	offensif
ceremony	cérémonie
conference	conférence
literature	litterature
techniques	techniques
francophone	francophone
efficacy	efficacité
bordeaux	bordeaux
bristol	bristol
battalion	bataillon
initiated	initié
tunnel	tunnel
recommended	recommandé
provisional	provisoire
turner	tourneur
transports	transports
signed	signé
anglican	anglican
agreements	accords
interdiction	interdiction
clubnat	clubnat
isère	isère
october	octobre
nationality	nationalité
now	maintenant
noblesse	noblesse
longs	longs
basses	basses
bishop	évêque
candidate	candidat
boxing	boxe
university	université
cyrillic	cyrillique
object	objet
elementary	élémentaire
animator	animateur
approved	approuvé
restaurants	restaurants
lesser	moindre
landes	landes
abraham	abraham
observed	observed
williams	williams
suspected	soupçonné
priest	prêtre
starred	étoilé
disputes	disputes
swiss	suisse
scolaire	scolaire
durant	durant
due	due
painters	peintres
partners	partenaires
empire	empire
decline	déclin
denmark	danemark
leaders	leaders
bis	bis
questions	questions
selection	sélection
terrains	terrains
signifier	signifiant
regions	régions
circle	cercle
descendants	descendants
jean	jean
hawaii	hawaii
altar	autel
forces	forces
aix	aix
result	résultat
constitution	constitution
affaires	affaires
literally	littéralement
adelaide	adelaide
assassinated	assassiné
decision	décision
primary	primaire
calcul	calcul
étienne	étienne
bons	bons
contributors	contributeurs
journalists	journalistes
rich	riche
biographical	biographique
wilaya	wilaya
arrangement	arrangement
inc	inc
visitor	visiteur
honor	honneur
hautes	hautes
saxe	saxe
lats	lats
kevin	kevin
dossier	dossier
integrated	intégré
activist	activiste
moulins	moulins
chaussée	chaussée
bases	bases
aménagement	aménagement
academic	académique
religieuses	religieuses
expositions	expositions
branches	branches
dictionary	dictionnaire
kong	kong
promote	promouvoir
gris	gris
trainer	entraîneur
journals	journaux
bosnia	bosnie
pilots	pilotes
minister	ministre
tel	tel
couleurs	couleurs
eye	œil
permanent	permanent
afd	afd
nomination	nomination
geneva	genève
constantinople	constantinople
francisco	francisco
francs	francs
building	bâtiment
alice	alice
propos	propos
ideas	idées
bank	banque
chiffre	chiffre
representative	représentatif
automatically	automatiquement
bâtiments	bâtiments
advance	avancer
affluent	affluent
days	jours
enemies	ennemis
hospitals	hôpitaux
suitable	suitable
productions	productions
naturelle	naturelle
mode	mode
deal	deal
briefly	brièvement
reasons	raisons
patrick	patrick
andy	andy
founder	fondateur
ralph	ralph
dublin	dublin
fantastique	fantastique
vendée	vendée
bla	bla
fa	fa
intervention	intervention
naturels	naturels
berkeley	berkeley
shall	shall
eddie	eddie
ministry	ministère
transition	transition
vague	vague
israeli	israélien
genres	genres
water	eau
expansion	expansion
severe	sévère
madison	madison
concert	concert
entretien	entretien
atlas	atlas
significant	significatif
jeff	jeff
denis	denis
instance	instance
encyclopaedia	encyclopédie
rivers	rivières
écrivains	écrivains
loir	loir
lost	perdu
nathalie	nathalie
achat	achat
alabama	alabama
finland	finlande
advantage	avantage
surgery	chirurgie
organ	orgue
arrêté	arrêté
editions	editions
turk	turc
spring	printemps
sides	côtés
crystal	cristal
systèmes	systèmes
mid	mid
edwards	edwards
habitually	habituellement
allies	alliés
appropriate	approprié
gods	dieux
attaché	attaché
function	fonction
jose	jose
parcours	parcours
http	http
remarkable	remarquable
chains	chaînes
seconds	secondes
reputation	réputation
athletes	athlètes
pioneer	pionnier
management	gestion
roux	roux
%	%
municipality	municipalité
infantry	infanterie
dna	dna
glass	verre
reaction	réaction
athletic	athlétique
brazil	brésil
less	moins
structure	structure
sufficient	suffisant
pseudo	pseudo
québécois	québécois
carlos	carlos
solid	solide
barcelona	barcelone
mitchell	mitchell
touristy	touristique
seeking	seeking
leads	leads
repertoire	répertoire
cordially	cordialement
aisne	aisne
café	café
operating	operating
pyramid	pyramide
concerns	concerns
base	base
picardy	picardie
dramatic	dramatique
illinois	illinois
hebrew	hébreu
outer	outer
leadership	leadership
sold	vendu
remnants	restes
augmentation	augmentation
netherlandish	néerlandais
napoleon	napoléon
louis	louis
brain	cerveau
concernant	concernant
captain	capitaine
biography	biographie
accused	accusé
executive	exécutif
official	officiel
rapide	rapide
breeding	élevage
clinton	clinton
illustrated	illustré
christmas	noël
battles	battles
watson	watson
encyclopedic	encyclopédique
isabelle	isabelle
manor	manoir
variable	variable
integral	intégral
richmond	richmond
milan	milan
apprenticeship	apprentissage
administration	administration
british	britannique
therapy	thérapie
double	double
completely	complètement
judges	juges
universitaires	universitaires
attacked	attaqué
congregation	congrégation
points	points
machine	machine
images	images
voted	voté
synthesis	synthèse
jane	jane
distinct	distinct
robinson	robinson
laboratory	laboratoire
decree	décret
blocks	blocs
companies	compagnies
vienne	vienne
battle	bataille
committee	comité
actions	actions
notables	notables
judgement	jugement
idea	idée
faits	faits
kent	kent
category	catégorie
frontier	frontière
exposition	exposition
berne	berne
capacities	capacités
decisions	décisions
historical	historique
concept	concept
nepal	nepal
organism	organisme
second	second
remix	remix
extract	extrait
impériale	impériale
buts	buts
opposition	opposition
mediterranean	méditerranéen
format	format
possibly	possiblement
voilà	voilà
derivatives	dérivés
defeats	défaites
column	colonne
anciennes	anciennes
armenia	arménie
judge	juge
steve	steve
restricted	restreint
conduite	conduite
machines	machines
simply	simplement
eagles	aigles
ensuite	ensuite
raoul	raoul
documentary	documentaire
seem	seem
other	autre
robert	robert
rural	rural
races	races
abuse	abus
avis	avis
maxi	maxi
bias	biais
jerome	jérôme
sacred	sacré
engineer	ingénieur
origines	origines
expert	expert
nevada	nevada
morale	morale
humanity	humanité
reprise	reprise
profundity	profondeur
org/wiki/	org/wiki/
supports	supports
collections	collections
daisy	marguerite
disappearance	disparition
publications	publications
gilles	gilles
ni	ni
passengers	passagers
ireland	irlande
radar	radar
enquête	enquête
hour	heure
exposé	exposé
reform	réforme
submission	soumission
irish	irlandais
habitants	habitants
restrictions	restrictions
parameter	paramètre
theories	théories
redirection	redirection
marshal	maréchal
vide	vide
byzantine	byzantin
amelioration	amélioration
aspx	aspx
legislative	législatif
specialists	spécialistes
contrast	contraste
old	vieux
suggestion	suggestion
density	densité
emission	émission
poem	poème
precision	précision
fortes	fortes
france	france
accident	accident
criteria	critères
task	tâche
incident	incident
fin	fin
interstate	interstate
naval	navale
resolution	résolution
beaux	beaux
île	island
pyrenees	pyrénées
memorial	mémorial
cavalry	cavalerie
hope	espérance
rush	rush
essay	essai
geography	géographie
copied	copié
url	url
gabriel	gabriel
installation	installation
complex	complexe
benefit	bénéfice
admissibility	admissibilité
charlie	charlie
effects	effets
euros	euros
internet	internet
célèbre	célèbre
airplane	avion
square	carré
sixty	soixante
continuous	continuous
rue	rue
barre	barre
telles	telles
mathematics	mathématiques
raising	raising
relationship	relationship
dissolution	dissolution
residence	résidence
instruments	instruments
howard	howard
perihelion	périhélie
outre	outre
félix	félix
gustave	gustave
rive	rive
poitiers	poitiers
boîte	boîte
mines	mines
details	détails
fan	fan
guidance	guidance
cloud	nuage
educational	éducatif
aérienne	aérienne
missouri	missouri
bourbon	bourbon
caractères	caractères
quebec	quebec
producers	producteurs
event	événement
beaten	battu
wines	vins
similarly	similairement
courage	courage
neutral	neutre
commandment	commandement
nîmes	nîmes
redaction	rédaction
seminary	séminaire
dangerous	dangereux
dallas	dallas
diverses	diverses
combats	combats
rares	rares
sicily	sicile
parisian	parisien
miguel	miguel
seigneurs	seigneurs
dijon	dijon
debates	débats
matin	matin
sovereign	souverain
difficulties	difficultés
obligatory	obligatoire
personally	personnellement
doctor	docteur
bureaux	bureaux
bande	bande
alfred	alfred
ok	ok
council	conseil
numérique	numérique
conserve	conserver
baroque	baroque
vancouver	vancouver
young	jeune
midday	midi
appointed	appointé
execution	exécution
coureur	coureur
franz	franz
google	google
bull	taureau
theology	théologie
kingdom	royaume
methods	méthodes
alcohol	alcool
universal	universel
intention	intention
yes	oui
again	again
avignon	avignon
spectacle	spectacle
christine	christine
models	modèles
entrainment	entraînement
solution	solution
definition	définition
parties	parties
continental	continental
petersburg	petersbourg
immigrants	immigrants
numerous	numerous
comprehensive	comprehensive
rayon	rayon
memoirs	mémoires
navarre	navarre
address	adresse
fred	fred
arnaud	arnaud
priory	prieuré
visit	visite
tropical	tropical
jon	jon
hauts	hauts
interface	interface
anna	anna
significance	significance
vladimir	vladimir
domination	domination
tour	tour
hits	hits
lebanon	lebanon
palace	palais
relegation	relégation
contraire	contraire
protein	protéine
soldats	soldats
basic	basique
collaboration	collaboration
petites	petites
bulgaria	bulgarie
english	anglaise
carrying	carrying
access	accès
sponsored	sponsorisé
police	police
sous	sous
carl	carl
quasi	quasi
efforts	efforts
paru	paru
item	item
liverpool	liverpool
contact	contact
prague	prague
prose	prose
aile	aile
bilan	bilan
merchandise	marchandises
vigil	veille
tempest	tempête
note	note
grammar	grammaire
provincial	provincial
workshop	atelier
qualifying	qualificatif
bonne	bonne
formal	formel
visited	visité
organisms	organismes
silver	argent
utah	utah
duties	devoirs
blason	blason
celtic	celtique
rupture	rupture
romanian	roumain
application	application
oil	huile
individual	individuel
she	elle
documentation	documentation
aaron	aaron
endemic	endémique
federal	fédéral
genre	genre
andré	andré
vienna	vienna
humour	humour
reconstruction	reconstruction
traditions	traditions
metz	metz
lieutenant	lieutenant
substantial	substantiel
telephone	téléphone
boss	boss
democrat	démocrate
daughters	filles
authors	auteurs
catherine	catherine
mouse	souris
lee	lee
gauge	jauge
arts	arts
terres	terres
arthur	arthur
member	membre
york	york
senator	sénateur
personality	personnalité
masculine	masculin
biological	biologique
microsoft	microsoft
eight	huit
tome	tome
orange	orange
total	total
steel	acier
nucléaire	nucléaire
documented	documenté
abbreviations	abréviations
amongst	amongst
artillery	artillerie
effect	effet
exception	exception
regards	regards
malade	malade
tomb	tombe
dimension	dimension
vapor	vapeur
march	marche
montage	montage
counselors	conseillers
gordon	gordon
naturelles	naturelles
garçons	garçons
aragon	aragon
montana	montana
partie	partie
haute	haute
mars	mars
discussions	discussions
antarctic	antarctique
control	contrôle
editors	éditeurs
spam	spam
messages	messages
refusal	refus
planets	planètes
variation	variation
composer	compositeur
mirror	miroir
contain	contain
loire	loire
patrimony	patrimoine
median	médiane
mayors	maires
representatives	représentants
guerres	guerres
liquid	liquide
antenna	antenne
landscapes	paysages
handball	handball
constructed	construit
bangladesh	bangladesh
championship	championnat
encourage	encourager
unluckily	malheureusement
rare	rare
principal	principal
lausanne	lausanne
trinity	trinité
champion	champion
arnold	arnold
explanation	explication
jurisdiction	jurisdiction
operated	operated
islamic	islamique
reed	roseau
monks	moines
symbol	symbole
limousin	limousin
seats	seats
mal	mal
abbot	abbé
vandalism	vandalisme
entity	entité
jerry	jerry
vocal	vocal
instructions	instructions
alan	alan
married	marié
husband	époux
jacob	jacob
europeans	européens
premiere	premiere
directe	directe
long	long
duchy	duché
lector	lecteur
attitude	attitude
criminal	criminel
mise	mise
avenue	avenue
institution	institution
elevation	élévation
buffalo	buffle
armies	armées
autonome	autonome
imprimerie	imprimerie
illustrious	illustre
forests	forêts
youtube	youtube
boulevard	boulevard
soi	soi
protection	protection
jones	jones
pressure	pression
minute	minute
allemande	allemande
cantons	cantons
appearances	apparences
knew	knew
femme	femme
bot	bot
measures	mesures
contemporaine	contemporaine
visitors	visiteurs
dave	dave
civil	civil
boulogne	boulogne
possibles	possibles
ait	ait
venice	venise
pages	pages
amendment	amendement
situations	situations
piano	piano
quentin	quentin
portraits	portraits
airport	aéroport
copies	copies
triple	triplé
terrestre	terrestre
campus	campus
objective	objectif
statistics	statistiques
preceding	précédant
modified	modifié
commun	commun
inferior	inférieur
revised	révisé
rc	rc
georges	georges
professionals	professionnels
squadron	escadrille
fiche	fiche
sean	sean
aphelion	aphélie
genetics	génétique
producer	producteur
archived	archivé
friedrich	friedrich
manga	manga
lyonnais	lyonnais
academy	académie
suppress	supprimer
guitarist	guitariste
stages	étapes
january	janvier
agriculture	agriculture
diffusion	diffusion
syndrome	syndrome
appellation	appellation
gardens	jardins
lien	lien
mother	mère
voyage	voyage
coastal	coastal
complete	complet
counsels	conseils
alexandre	alexandre
lundi	lundi
tenue	tenue
period	période
harvard	harvard
relatively	relativement
patients	patients
screen	écran
minutes	minutes
combatants	combattants
assistant	assistant
harvey	harvey
publishing	publishing
cords	cordes
hectares	hectares
arbcom	arbcom
littéraires	littéraires
principaux	principaux
astronomer	astronome
coi	coi
surrounded	entouré
shakespeare	shakespeare
treatment	traitement
soldier	soldat
placer	placer
colin	colin
disease	maladie
construction	construction
archives	archives
ehess	ehess
capture	capture
travers	travers
risks	risques
troubles	troubles
hugues	hugues
inde	inde
branch	branche
hollywood	hollywood
mort	mort
dispositive	dispositif
manuscripts	manuscrits
tamil	tamil
psychology	psychologie
suggestions	suggestions
israel	israël
vehicle	véhicule
credited	crédité
ans	ans
prefect	préfet
participants	participants
sign	signe
measure	mesure
arizona	arizona
commentary	commentaire
buddhist	bouddhiste
fédérale	fédérale
concerning	concerning
parent	parent
interesting	intéressant
problems	problèmes
hurricane	ouragan
armand	armand
assassination	assassinat
menace	menace
constantin	constantin
apostolic	apostolique
race	race
dream	rêve
sainte	sainte
bulgarian	bulgare
thirteen	treize
secrets	secrets
limit	limite
private	privé
makeup	maquillage
refuge	refuge
security	sécurité
approximately	approximativement
inscription	inscription
muslim	musulman
hubert	hubert
gaulle	gaulle
basis	basis
brussels	bruxelles
personalities	personnalités
joan	joan
traduction	traduction
john	john
murray	murray
craig	craig
inventory	inventaire
nintendo	nintendo
two	deux
biology	biologie
gallimard	gallimard
poitou	poitou
rocky	rocheux
disney	disney
annual	annuel
plat	plat
languedoc	languedoc
california	californie
syndicate	syndicat
canadiens	canadiens
gang	gang
duration	durée
jeanne	jeanne
position	position
geolocation	géolocalisation
johann	johann
palestine	palestine
reservoir	réservoir
indiana	indiana
ukrainian	ukrainien
organic	organique
operate	opérer
extremity	extrémité
certaine	certaine
rouge	rouge
correct	correct
turin	turin
ascendant	ascendant
roberts	roberts
preface	préface
rabbi	rabbin
occupation	occupation
internationales	internationales
uns	uns
kennedy	kennedy
approach	approche
dominique	dominique
tank	tank
gallo	gallo
pistes	pistes
trafic	trafic
absence	absence
manufacturers	manufacturers
warsaw	varsovie
tableau	tableau
installations	installations
credit	crédit
proposal	proposal
trophy	trophée
gaston	gaston
books	livres
sources	sources
tennessee	tennessee
hugo	hugo
neighborhood	neighborhood
bands	bandes
electricity	électricité
efficacious	efficace
invitees	invités
queensland	queensland
halls	salles
precisely	précisément
marco	marco
baron	baron
tournois	tournois
finance	finance
harold	harold
semi	semi
central	central
programmes	programmes
jonathan	jonathan
chambers	chambres
influences	influences
clement	clément
experts	experts
fought	fought
elevated	élevé
bon	bon
svg	svg
atmosphere	atmosphère
themes	thèmes
sort	sort
nouvel	nouvel
bomb	bombe
reconnaissance	reconnaissance
vigor	vigueur
human	humain
juste	juste
violation	violation
opinions	opinions
quarters	quartiers
computer	ordinateur
founders	fondateurs
somme	somme
orchestra	orchestre
josé	josé
ami	ami
chefs	chefs
emissions	émissions
economical	économique
lit	lit
representations	représentations
european	européen
azure	azur
anti	anti
overture	ouverture
revolt	révolte
neuf	neuf
joué	joué
september	septembre
belles	belles
suffering	souffrance
literary	littéraire
tiger	tigre
persons	persons
edmond	edmond
wilhelm	wilhelm
values	valeurs
têtes	têtes
anciens	anciens
non	non
assure	assurer
exclusively	exclusivement
étrangères	étrangères
dual	dual
style	style
organisations	organisations
hungary	hongrie
peninsula	péninsule
farmers	agriculteurs
emperor	empereur
authority	autorité
and/or	et/ou
totality	totalité
rarely	rarement
venezuela	venezuela
christian	chrétien
virtual	virtuel
nul	nul
inhabitant	habitant
provinces	provinces
roman	romain
studies	etudes
championships	championnats
hockey	hockey
canadienne	canadienne
treaty	traité
download	téléchargement
edgar	edgar
elena	elena
children	enfants
camille	camille
barrage	barrage
respect	respect
louisiana	louisiana
image	image
continent	continent
breaking	breaking
qualities	qualités
travailleurs	travailleurs
integration	intégration
owned	owned
enterprise	entreprise
extreme	extrême
preferred	préféré
fairly	fairly
sojourn	séjour
jimmy	jimmy
coordinates	coordonnées
voici	voici
decoration	décoration
fernand	fernand
counties	comtés
italian	italien
teachers	enseignants
marie	marie
regional	régional
neuve	neuve
manifesto	manifeste
physique	physique
property	propriété
considering	considérant
promotion	promotion
contributor	contributrice
tigers	tigres
waters	eaux
auguste	auguste
plan	plan
elections	élections
tiers	tiers
domain	domaine
ancient	ancien
pianist	pianiste
variety	variété
acceptable	acceptable
presidential	présidentiel
virgin	vierge
theory	théorie
hispanic	hispanique
reduce	réduire
ryan	ryan
morceaux	morceaux
épée	épée
procureur	procureur
foundation	fondation
would	voudrais
participation	participation
racial	racial
supporters	supporters
virus	virus
garçon	garçon
correspondence	correspondance
frequently	fréquemment
couples	couples
monuments	monuments
and	et
friday	vendredi
renault	renault
publics	publics
apple	pomme
inter	inter
strasbourg	strasbourg
corporate	corporate
interior	intérieur
sullivan	sullivan
anthony	anthony
nothing	rien
souvenirs	souvenirs
received	reçu
missing	manquant
wikipedia	wikipédia
advanced	avancé
determined	déterminé
philippine	philippine
hindu	hindou
apparition	apparition
categories	catégories
portail	portail
usine	usine
agricole	agricole
monk	moine
than	than
teams	teams
importance	importance
history	histoire
sunday	dimanche
gardien	gardien
personnel	personnel
investment	investissement
half	moitié
specifics	spécifiques
antiquity	antiquité
philosopher	philosophe
passages	passages
urls	urls
guitar	guitare
limites	limites
matthew	matthew
beyond	beyond
tent	tente
diff	diff
faces	visages
venu	venu
although	although
johnson	johnson
similar	similaire
thesis	thèse
civilians	civils
tokyo	tokyo
brunswick	brunswick
notes	notes
concentration	concentration
soviet	soviet
philippines	philippines
winners	gagnants
côte	côte
cooperation	coopération
proprietor	propriétaire
celestial	céleste
gironde	gironde
brooklyn	brooklyn
suspended	suspendu
sable	sable
minor	mineur
toulouse	toulouse
lorraine	lorraine
anomaly	anomalie
congress	congrès
rewards	récompenses
broadcasting	broadcasting
basque	basque
technologies	technologies
oxford	oxford
ceo	ceo
progress	progrès
caribbean	caraïbe
gamut	gamme
fifty	cinquante
washington	washington
vosges	vosges
bob	bob
examples	examples
sports	sports
succession	succession
composers	compositeurs
recently	récemment
statistic	statistique
inhabitants	inhabitants
iranian	iranien
great	great
gallery	galerie
gros	gros
principles	principes
métier	métier
sector	secteur
fpu	fpu
offer	offre
intermediary	intermédiaire
catalonia	catalogne
armed	armé
heights	hauteurs
recourse	recours
temperature	température
malaysia	malaisie
confederate	confédéré
fêtes	fêtes
chapel	chapelle
stockholm	stockholm
blockage	blocage
missions	missions
lucas	lucas
definitively	définitivement
signature	signature
canons	canons
atlantic	atlantique
latitude	latitude
instruction	instruction
violin	violon
populations	populations
gouv	gouv
nominated	nominé
architect	architecte
value	valeur
convinced	convaincu
lambert	lambert
karl	karl
constructions	constructions
croatia	croatie
me,	moi
debt	dette
commentaries	commentaires
sisters	sœurs
present	présent
functioning	fonctionnement
cbs	cbs
profession	profession
ultimate	ultime
design	design
some	some
issus	issus
attacks	attaques
lourd	lourd
confluence	confluence
mixte	mixte
tramway	tramway
frequency	fréquence
pacific	pacifique
electoral	électoral
reaching	reaching
asteroids	astéroïdes
final	final
hermann	hermann
solo	solo
dispute	dispute
hugh	hugh
douglas	douglas
patient	patient
transmission	transmission
us,	nous
participle	participe
constitutional	constitutionnel
mobile	mobile
go	go
interested	intéressé
volumes	volumes
characteristic	caractéristique
composition	composition
histoires	histoires
information	information
impact	impact
rapidly	rapidement
ci	ci
vite	vite
theme	thème
hamilton	hamilton
emphasis	emphasis
facebook	facebook
cambridge	cambridge
interne	interne
star	étoile
lot	lot
radical	radical
orbit	orbite
occasionally	occasionnellement
select_resultat	select_resultat
brisbane	brisbane
essentially	essentiellement
locality	localité
marcel	marcel
credits	crédits
administratively	administrativement
public	public
defensive	défensif
tribe	tribu
vincent	vincent
sites	sites
jew	juif
wikipedians	wikipédiens
indonesia	indonésie
alaska	alaska
peasants	paysans
nourishment	nourriture
movements	movements
progressively	progressivement
useless	inutile
novels	romans
rfc	rfc
habitat	habitat
liaison	liaison
testament	testament
libraries	bibliothèques
aspect	aspect
pakistani	pakistanais
jules	jules
competencies	compétences
territorial	territorial
aura	aura
dvd	dvd
clay	argile
establishment	establishment
platform	plateforme
oriental	oriental
albums	albums
tool	outil
were	were
embassy	ambassade
espagnol	espagnol
knot	nœud
sydney	sydney
elsewhere	ailleurs
gain	gain
kilometers	kilomètres
christianity	christianisme
pire	pire
difficult	difficile
experienced	experienced
retired	retiré
minimum	minimum
lucien	lucien
films	films
existing	existing
reserve	réserve
blog	blogue
harris	harris
tard	tard
lloyd	lloyd
illustration	illustration
consensus	consensus
indigenous	indigène
rotation	rotation
parle	parle
conclusion	conclusion
titres	titres
translator	traducteur
bibliography	bibliographie
alsace	alsace
mtv	mtv
philippe	philippe
organised	organisé
proprietors	propriétaires
algeria	algérie
events	événements
xixe	xixe
toponym	toponyme
million	million
delegation	délégation
slaves	esclaves
marne	marne
direction	direction
philosophy	philosophie
ottawa	ottawa
anderson	anderson
agglomeration	agglomération
reasonable	raisonnable
roland	roland
sourcing	sourcing
giants	géants
mathematician	mathématicien
destined	destiné
religious	religieux
facing	facing
displacement	déplacement
domicile	domicile
militant	militant
affected	affecté
ruins	ruines
africain	africain
gregory	grégoire
thomas	thomas
establish	établir
rené	rené
candidature	candidature
eliminated	éliminé
bien	bien
ottoman	ottoman
oblast	oblast
princess	princesse
scientific	scientifique
endowed	doté
degrees	degrés
formant	formant
julien	julien
inverse	inverse
troupe	troupe
arguments	arguments
criticism	critique
pedro	pedro
internationally	internationalement
encore	encore
horror	horreur
campbell	campbell
playstation	playstation
massacre	massacre
comprehend	comprendre
manuscript	manuscrit
reserves	réserves
industrielle	industrielle
century	siècle
blue	bleu
changed	changé
aux	aux
observations	observations
enceinte	enceinte
maximum	maximum
conflict	conflit
shah	shah
lance	lance
montreal	montréal
our	notre
laurent	laurent
families	familles
bonnes	bonnes
savage	sauvage
vingtaine	vingtaine
xviie	xviie
guards	gardes
stuart	stuart
martin	martin
fera	fera
without	sans
optics	optique
tension	tension
reunion	réunion
meilleure	meilleure
appearance	apparence
exact	exact
prevent	prévenir
catholic	catholique
opportunity	opportunité
degree	degré
champs	champs
what	quoi
legend	légende
aîné	aîné
ian	ian
cape	cape
wikimedia	wikimedia
eccentricity	excentricité
dire	dire
champagne	champagne
paroles	paroles
orders	ordres
recherches	recherches
user	utilisateur
khan	khan
forbidden	interdit
realized	réalisé
italians	italiens
host	hôte
guard	garde
passage	passage
belgium	belgique
animal	animal
motors	moteurs
province	province
arkansas	arkansas
three	trois
italy	italie
wings	ailes
prêt	prêt
ferme	ferme
adams	adams
morts	morts
dennis	dennis
changement	changement
juive	juive
bref	bref
also	aussi
activity	activité
gilbert	gilbert
lighthouse	phare
participant	participant
fauna	faune
musician	musicien
independents	indépendants
berlin	berlin
symphony	symphonie
relations	relations
gary	gary
technique	technique
concerts	concerts
delta	delta
chef	chef
dames	dames
saskatchewan	saskatchewan
probable	probable
prison	prison
ideal	idéal
published	publié
facile	facile
jj	jj
december	décembre
planet	planète
medals	médailles
bringing	bringing
vermont	vermont
leeds	leeds
hazard	hasard
lake	lac
hospital	hôpital
production	production
crash	crash
medical	médical
documents	documents
inspector	inspecteur
plateau	plateau
response	réponse
favorable	favorable
terry	terry
thérèse	thérèse
expedition	expédition
arbiter	arbitre
estimated	estimated
traditional	traditionnel
presentation	présentation
programming	programmation
fait	fait
amateurs	amateurs
roger	roger
darkgrey	darkgrey
robot	robot
vii	vii
martial	martial
maritime	maritime
combat	combat
sanctuary	sanctuaire
christians	chrétiens
architecture	architecture
uss	uss
republican	républicain
protégé	protégé
parti	parti
physiques	physiques
indian	indien
tall	tall
responsible	responsable
adventure	aventure
denomination	dénomination
raymond	raymond
hudson	hudson
harrison	harrison
games	jeux
option	option
arena	arène
rapports	rapports
rejected	rejeté
socorro	socorro
munich	munich
guitars	guitars
hero	héros
rights	droits
phenomenon	phénomène
avais	avais
adapted	adapté
agents	agents
nigeria	nigeria
congressional	congressional
carlo	carlo
autonomy	autonomie
belgrade	belgrade
generation	génération
ministers	ministres
marc	marc
toujours	toujours
energy	énergie
emmanuel	emmanuel
prisoner	prisonnier
chacun	chacun
separation	séparation
reporter	reporter
expression	expression
four	quatre
bishops	évêques
equality	égalité
caesar	césar
sont	sont
brick	brique
accent	accent
platforms	plateformes
diego	diego
orléans	orléans
principle	principe
trouble	trouble
anonymous	anonyme
disques	disques
necessity	nécessité
among	among
nef	nef
stanley	stanley
provence	provence
west	ouest
coalition	coalition
bbc	bbc
campaigns	campagnes
fonctions	fonctions
explosion	explosion
easily	facilement
equal	égal
auvergne	auvergne
cotton	coton
votes	votes
june	juin
beijing	beijing
flying	flying
norwegian	norvégien
spectators	spectateurs
ecology	écologie
bush	buisson
attacker	attaquant
objects	objets
character	caractère
adversary	adversaire
instrumental	instrumental
nations	nations
angleterre	angleterre
alexis	alexis
reduction	réduction
cross	croix
olympique	olympique
practically	pratiquement
sultan	sultan
notability	notabilité
code	code
distributed	distribué
afghanistan	afghanistan
fruits	fruits
assault	assaut
joe	joe
jersey	jersey
abbey	abbaye
immediate	immédiat
alternative	alternative
officers	officiers
driven	driven
controversial	controversial
espoirs	espoirs
communities	communautés
korean	coréen
secondary	secondaire
resident	résident
circuit	circuit
defender	défenseur
message	message
styles	styles
conversion	conversion
brazilian	brésilien
angel	ange
duo	duo
ceinture	ceinture
programme	programme
camera	caméra
todd	todd
territories	territoires
bateaux	bateaux
modern	moderne
viens	viens
amsterdam	amsterdam
belgian	belge
additions	additions
qualified	qualifié
yorkshire	yorkshire
pennsylvania	pennsylvanie
enfant	enfant
michigan	michigan
marque	marque
quinze	quinze
establishments	établissements
earthquake	tremblement
familiar	familier
multiples	multiples
population	population
latino	latino
effort	effort
étudiants	étudiants
urgency	urgence
supplementary	supplémentaire
leipzig	leipzig
dynasty	dynastie
lgbt	lgbt
architects	architectes
special	spécial
sierra	sierra
honors	honneurs
distinction	distinction
armenian	arménien
wellington	wellington
politics	politiques
necessarily	necessarily
alpha	alpha
horses	chevaux
mission	mission
question	question
limited	limité
norm	norme
marin	marin
truck	camion
lille	lille
executed	exécuté
motor	moteur
madrid	madrid
won	gagné
musical	musical
creative	créatif
journalism	journalisme
eponymous	éponyme
operational	opérationnel
ardennes	ardennes
inspiration	inspiration
democratic	démocratique
socialist	socialiste
invasion	invasion
org/w/index	org/w/index
revolutionary	révolutionnaire
rome	rome
responsibility	responsabilité
deposited	déposé
sporty	sportif
loss	perte
traversée	traversée
partnership	partenariat
johnny	johnny
proof	preuve
merit	mérite
iowa	iowa
relay	relais
increasing	increasing
lane	lane
manifestation	manifestation
ze	ze
metropole	métropole
equilibrium	équilibre
institute	institut
seat	seat
honored	honoré
power	pouvoir
andrew	andrew
seal	sceau
cultures	cultures
minority	minorité
national	national
parks	parcs
organisation	organisation
flux	flux
mans	mans
powers	pouvoirs
percussion	percussion
garonne	garonne
reflexion	réflexion
adam	adam
medal	médaille
knights	chevaliers
danish	danois
anjou	anjou
lourdes	lourdes
toi	toi
destination	destination
exclusive	exclusif
invitee	invité
bruges	bruges
types	types
philadelphia	philadelphie
studios	studios
announcement	annonce
slave	esclave
fundamental	fondamental
bring	bring
senegal	sénégal
suburb	banlieue
civilization	civilisation
miami	miami
tax	taxe
footballers	footballeurs
observatory	observatoire
creation	création
departments	départements
baptist	baptiste
uefa	uefa
utilisation	utilisation
electric	électrique
taiwan	taiwan
tentative	tentative
retreat	retraite
conferences	conférences
formula	formule
locomotives	locomotives
adventures	aventures
july	juillet
massachusetts	massachusetts
evaluation	évaluation
suppression	suppression
actuel	actuel
grande	grande
pearl	perle
scenarist	scénariste
mississippi	mississippi
index	indice
enemy	ennemi
wayne	wayne
impossible	impossible
tours	tours
forme	forme
principally	principalement
solaire	solaire
editorial	éditorial
target	cible
offering	offrande
conservator	conservateur
drawings	dessins
blogspot	blogspot
should	devrait
males	mâles
initiative	initiative
subjects	sujets
moore	moore
dome	dôme
voile	voile
wound	blessure
oakland	oakland
clearly	clairement
stéphane	stéphane
urbaine	urbaine
must	must
helen	hélène
soirée	soirée
reliant	reliant
raw	raw
clubs	clubs
operations	opérations
metal	métal
accompanied	accompagné
regiment	régiment
supreme	suprême
presence	présence
files	fichiers
expatriate	expatrié
normandy	normandie
iso	iso
monastery	monastère
commented	commenté
louise	louise
zurich	zurich
locations	locations
distance	distance
properties	propriétés
artistic	artistique
edition	édition
hosted	hébergé
unique	unique
margin	marge
governors	gouverneurs
hui	hui
dogs	chiens
lycée	lycée
battery	batterie
encounters	rencontres
sols	sols
dedicated	dédié
immediately	immédiatement
ancienne	ancienne
aquitaine	aquitaine
naturel	naturel
lincoln	lincoln
commerce	commerce
durable	durable
thoughts	pensées
supérieure	supérieure
heir	héritier
coups	coups
texts	textes
tommy	tommy
athletics	athlétisme
submissive	soumis
thai	thai
contemporaries	contemporains
embouchure	embouchure
casualties	casualties
contested	contesté
where	où
walter	walter
photos	photos
sheffield	sheffield
egypt	égypte
charlotte	charlotte
rangers	rangers
alberto	alberto
largely	largement
fourteen	quatorze
strategic	stratégique
clerk	clerc
wang	wang
local	local
bernard	bernard
talent	talent
sept	sept
episodes	épisodes
murder	meurtre
flowers	fleurs
scientifiques	scientifiques
vision	vision
collective	collectif
industrial	industriel
basse	basse
islam	islam
retour	retour
jordan	jordan
love	amour
military	militaire
subdivision	subdivision
voies	voies
tribunal	tribunal
essential	essentiel
statues	statues
possession	possession
nantes	nantes
nephew	neveu
violence	violence
vertical	vertical
susan	susan
initial	initial
airplanes	avions
codes	codes
conserved	conservé
color	couleur
assisted	assisté
notoriety	notoriété
simple	simple
faut	faut
condemned	condamné
workshops	ateliers
hervé	hervé
anniversary	anniversaire
yet	yet
toronto	toronto
grade	grade
fut	fut
that,	cela
alphonse	alphonse
ninth	neuvième
segment	segment
weblog	blog
alpine	alpin
dragons	dragons
constituted	constitué
voyageurs	voyageurs
marsh	marais
anne	anne
besançon	besançon
officer	officier
coach	coach
petits	petits
élite	élite
citation	citation
pittsburgh	pittsburgh
direct	direct
professional	professionnel
influence	influence
argentine	argentine
catholics	catholiques
journalist	journaliste
cat	chat
club	club
liberation	libération
amiens	amiens
split	split
surveillance	surveillance
engraver	graveur
suggest	suggest
internationals	internationaux
hamlet	hameau
toulon	toulon
calculated	calculé
responses	réponses
vast	vaste
comic	comique
ukraine	ukraine
nationales	nationales
mauvais	mauvais
promotional	promotional
kenya	kenya
agencies	agences
pic	pic
inspired	inspiré
parliamentary	parlementaire
magazines	magazines
denver	denver
intellectual	intellectuel
dragon	dragon
eugene	eugène
costumes	costumes
cemetery	cimetière
sexual	sexuel
ethnic	ethnique
villages	villages
spiders	araignées
zones	zones
noble	noble
knowledges	connaissances
perfectly	parfaitement
budapest	budapest
entrée	entrée
occasion	occasion
unity	unité
grotto	grotte
controversy	controverse
germanic	germanique
chronology	chronologie
espaces	espaces
contre	contre
camps	camps
thierry	thierry
kansas	kansas
slovakia	slovaquie
capacity	capacité
belong	belong
logic	logique
twenty	vingt
honorary	honoraire
palmares	palmarès
complète	complète
delhi	delhi
poet	poète
artist	artiste
negotiations	négociations
vitesse	vitesse
esteem	estime
leader	leader
utility	utilité
inclination	inclinaison
origine	origine
canadian	canadien
action	action
army	armée
simon	simon
general	général
exchange	échange
chicago	chicago
repose	repose
uniform	uniforme
corps	corps
arc	arc
colleges	collèges
legitimate	légitime
serge	serge
québécoise	québécoise
vise	vise
birth	naissance
reign	règne
petite	petite
dick	dick
men	hommes
seigniory	seigneurie
artificial	artificiel
occupied	occupé
dynamic	dynamique
jette	jette
ocean	océan
element	élément
flotte	flotte
hair	cheveux
archaeology	archéologie
priests	prêtres
austin	austin
espagnole	espagnole
monument	monument
scotland	écosse
through	through
collins	collins
milieu	milieu
inconnu	inconnu
citations	citations
czech	tchèque
diamond	diamant
resolved	résolu
pete	pete
president	président
league	ligue
mille	mille
syria	syrie
maladies	maladies
detail	détail
historically	historiquement
force	force
circulation	circulation
edits	edits
junior	junior
relation	relation
matériel	matériel
automobile	automobile
disambiguation	disambiguation
coaches	coaches
american	américain
discourse	discours
ballet	ballet
columns	colonnes
eligible	éligible
illustrations	illustrations
heritage	héritage
chess	échecs
gulf	golfe
shanghai	shanghai
ferdinand	ferdinand
lots	lots
connecticut	connecticut
courant	courant
professionnelle	professionnelle
maryland	maryland
angle	angle
germain	germain
athens	athènes
bonaparte	bonaparte
document	document
nazi	nazi
distribution	distribution
tonnes	tonnes
mur	mur
taille	taille
discipline	discipline
francis	francis
senators	sénateurs
difficulty	difficulté
apparent	apparent
graham	graham
thank	merci
balloon	ballon
bertrand	bertrand
sociology	sociologie
phillips	phillips
procès	procès
enfance	enfance
volume	volume
saudi	saudi
couche	couche
wimbledon	wimbledon
sortie	sortie
portion	portion
ascension	ascension
pitcher	pitcher
aspects	aspects
trio	trio
terme	terme
several	several
son	fils
orthodox	orthodoxe
antwerp	anvers
sociales	sociales
overlap	overlap
administrator	administrateur
suffered	souffert
commissaire	commissaire
hughes	hughes
satellite	satellite
excellent	excellent
pakistan	pakistan
florida	florida
departmental	départemental
acquisition	acquisition
prefecture	préfecture
destroyed	détruit
impression	impression
victoires	victoires
volunteers	bénévoles
evans	evans
waste	déchet
nicole	nicole
informed	informé
paul	paul
troupes	troupes
diesel	diesel
grenoble	grenoble
roberto	roberto
forced	forcé
institutions	institutions
consult	consulter
or	or
example	exemple
organiser	organiser
processus	processus
recitals	récits
voivodeship	voïvodie
alex	alex
brun	brun
paintings	peintures
spéciale	spéciale
tools	outils
gloire	gloire
hc	hc
draughtsman	dessinateur
propositions	propositions
auckland	auckland
side	côté
grace	grâce
pointe	pointe
versailles	versailles
ron	ron
absolutely	absolument
henry	henry
convention	convention
conditions	conditions
tunis	tunis
age	âge
colony	colonie
november	novembre
rebellion	rébellion
variations	variations
masse	masse
sculptor	sculpteur
vit	vit
bruce	bruce
circumstances	circonstances
house,	maison
frederick	frédéric
princes	princes
coupes	coupes
tar	tar
partis	partis
harry	harry
austrian	autrichien
particuliers	particuliers
determine	déterminer
virginie	virginie
aviation	aviation
thailand	thaïlande
corporation	corporation
metro	métro
rois	rois
nature	nature
maria	maria
demi	demi
emblem	emblème
solutions	solutions
diplomatic	diplomatique
detailed	détaillé
successively	successivement
applications	applications
polonaise	polonaise
trend	tendance
accounts	comptes
contemporary	contemporain
considerable	considérable
quantity	quantité
rouges	rouges
routes	routes
marquis	marquis
cuba	cuba
defeat	défaite
fortress	forteresse
interest	intérêt
addition	addition
greek	grec
finances	finances
nbc	nbc
communication	communication
engineers	ingénieurs
px	px
ring	anneau
doit	doit
method	méthode
signal	signal
rogers	rogers
bytes	bytes
amie	amie
madagascar	madagascar
monsieur	monsieur
losses	pertes
aide	aide
ecliptic	écliptique
block	bloc
exactly	exactement
commander	commandeur
archbishop	archevêque
photographer	photographe
grades	grades
thompson	thompson
publisher	éditeur
antonio	antonio
sculpture	sculpture
welcome	bienvenue
trains	trains
elements	éléments
extension	extension
statue	statue
drugs	drogues
evolution	évolution
their	leur
brigade	brigade
jesus	jésus
portuguese	portugais
advisory	advisory
linguistic	linguistique
terms	termes
titular	titulaire
illegal	illégal
strike	grève
oscar	oscar
billion	milliard
thu	thu
countess	comtesse
predecessor	prédécesseur
transferred	transféré
declared	déclaré
borough	borough
cgi	cgi
photographs	photographs
eleven	onze
madeleine	madeleine
elected	élu
governor	gouverneur
across	across
vocals	vocals
cards	cartes
formally	formellement
francophones	francophones
multiple	multiple
jerusalem	jérusalem
sufficiently	suffisamment
constant	constant
concurrence	concurrence
billy	billy
staircase	escalier
proximity	proximité
postal	postal
heinrich	heinrich
broadcast	broadcast
luke	luke
americans	américains
surprise	surprise
license	licence
gospel	évangile
giovanni	giovanni
bulletin	bulletin
benjamin	benjamin
milwaukee	milwaukee
possible	possible
urss	urss
introduction	introduction
texas	texas
objectives	objectifs
visible	visible
roches	roches
species	espèces
outdoors	dehors
sometimes	sometimes
jul	jul
archaeological	archéologique
partially	partiellement
alain	alain
uk	uk
stanford	stanford
township	township
instrument	instrument
phases	phases
certified	certifié
schools	écoles
australia	australie
electronic	électronique
eighth	huitième
roles	rôles
diocese	diocèse
citizens	citoyens
muslims	musulmans
separated	séparé
lp	lp
motorway	autoroute
penalty	pénalité
atp	atp
counselor	conseiller
signs	signes
rounds	rondes
hypothesis	hypothèse
quotidian	quotidien
victims	victimes
flat	flat
meuse	meuse
juan	juan
discovery	découverte
dh	dh
piste	piste
boston	boston
economy	économie
commandant	commandant
thirty	trente
morris	morris
résumé	résumé
yugoslavia	yougoslavie
dimensions	dimensions
sncf	sncf
santiago	santiago
wickets	wickets
plain	plain
wallace	wallace
widow	veuve
atlanta	atlanta
diameter	diamètre
suis	suis
geographical	géographique
caption	caption
anglo	anglo
columbus	columbus
discussion	discussion
whether	whether
michel	michel
delivered	délivré
comparison	comparaison
santa	santa
classified	classé
nancy	nancy
chili	chili
newcastle	newcastle
cannes	cannes
liberal	libéral
madame	madame
austria	autriche
seuil	seuil
equator	équateur
luxembourg	luxembourg
accessible	accessible
norms	normes
existence	existence
caroline	caroline
scenes	scènes
chansons	chansons
longitude	longitude
consequences	conséquences
salut	salut
administrators	administrateurs
brothers	frères
fabrication	fabrication
metropolitan	métropolitain
opera	opéra
dollars	dollars
progressive	progressiste
section	section
lublin	lublin
situation	situation
fleuve	fleuve
scope	scope
florence	florence
avocado	avocat
examination	examen
spaniards	espagnols
potential	potentiel
album	album
scoring	scoring
normal	normal
david	david
card	carte
characteristics	caractéristiques
nouveau	nouveau
zone	zone
savoy	savoie
appliances	appareils
monaco	monaco
centuries	siècles
feb	feb
faculty	faculté
chemistry	chimie
graphic	graphique
liberated	libéré
qualification	qualification
produce	produire
cash	cash
navigation	navigation
jason	jason
suppressed	supprimé
morsel	morceau
lawyers	avocats
dakota	dakota
competitive	compétitif
financing	financement
county	comté
duchess	duchesse
mazovia	mazovie
daniel	daniel
cathedral	cathédrale
baby	bébé
supérieures	supérieures
imperial	impérial
actresses	actrices
japonais	japonais
nobody	nobody
mystery	mystère
projects	projets
chan	chan
australian	australien
kelly	kelly
round	rond
commission	commission
sony	sony
croatian	croate
engineering	ingénierie
states	états
naples	naples
lewis	lewis
authorisation	autorisation
modifications	modifications
committed	committed
singapore	singapour
caen	caen
victorian	victorien
pavilion	pavillon
swimsuit	maillot
nation	nation
uncle	oncle
government	gouvernement
cameroon	cameroun
lie	mensonge
success	réussite
churches	églises
residential	résidentiel
nicolas	nicolas
summit	sommet
important	important
secret	secret
hours	heures
potentially	potentiellement
social	social
island	île
mental	mental
stadium	stade
correspondent	correspondant
twelve	douze
quay	quai
edifice	édifice
scrutiny	scrutin
debut	debut
hunters	chasseurs
jamais	jamais
gene	gène
video	vidéo
restoration	restauration
pdd	pdd
services	services
édouard	édouard
enterprises	entreprises
expatriates	expatriés
champ	champ
growth	croissance
moscow	moscou
sourced	sourcé
scheduled	scheduled
laureate	lauréat
finnish	finnois
finalist	finaliste
bobby	bobby
duke	duc
mason	maçon
movement	mouvement
cannon	canon
blp	blp
authorities	autorités
chapter	chapitre
crisis	crise
mohamed	mohamed
experience	expérience
settlement	settlement
musics	musiques
bird	oiseau
linear	linéaire
citizen	citoyen
interaction	interaction
plans	plans
breton	breton
manifestations	manifestations
ferrari	ferrari
rooftop	toit
ffffff	ffffff
marseille	marseille
mythology	mythologie
salt	sel
choix	choix
climate	climat
declaration	déclaration
directly	directement
surface	surface
protégée	protégée
assembly	assemblée
regulations	règlements
altitude	altitude
development	développement
professor	professeur
straight	straight
serious	sérieux
corea	corée
butterfly	papillon
feminine	féminin
abandoned	abandonné
student	étudiant
samedi	samedi
context	contexte
six	six
publicly	publiquement
sections	sections
candidates	candidats
ivan	ivan
royal	royal
russe	russe
commercial	commercial
pris	pris
nickname	surnom
renaissance	renaissance
opinion	opinion
historians	historiens
file	fichier
cincinnati	cincinnati
uni	uni
senior	senior
towards	towards
essence	essence
real	réel
animated	animé
prince	prince
militaires	militaires
highways	highways
strangers	étrangers
occidental	occidental
sense	sens
dates	dates
loi	loi
mayotte	mayotte
members	membres
transference	transfert
vf	vf
limoges	limoges
clan	clan
juridical	juridique
however	however
noms	noms
politicians	politiciens
depression	dépression
conservation	conservation
interpreter	interprète
faites	faites
wilson	wilson
charcoal	charbon
cuisine	cuisine
dame	dame
birds	oiseaux
purposes	purposes
tf	tf
suicide	suicide
constante	constante
edifices	édifices
prisoners	prisonniers
type	type
budget	budget
romantic	romantique
improvements	améliorations
zero	zéro
convent	couvent
cable	câble
scores	scores
immigration	immigration
relief	soulagement
exploitation	exploitation
animation	animation
tony	tony
muet	muet
envers	envers
carolina	carolina
superior	supérieur
feuilles	feuilles
azerbaijan	azerbaidjan
different	différent
scottish	écossais
nonetheless	néanmoins
telefilm	téléfilm
exchanges	échanges
larry	larry
scenario	scénario
derby	derby
mention	mention
gradually	graduellement
operation	opération
dieu	dieu
masters	maîtres
backing	backing
sole	sole
interpretation	interprétation
marble	marbre
successor	successeur
partisans	partisans
automatic	automatique
respectively	respectivement
specialized	spécialisé
donald	donald
distinctions	distinctions
scott	scott
val	val
treasure	trésor
leave	leave
federation	fédération
sarah	sarah
materials	matériaux
banks	banques
fonds	fonds
periods	périodes
jacques	jacques
boris	boris
athlete	athlète
regular	régulier
hosts	hôtes
alberta	alberta
matt	matt
vraie	vraie
nebraska	nebraska
melbourne	melbourne
regularly	régulièrement
carrier	porteur
suivi	suivi
domains	domaines
dance	danse
recent	récent
arles	arles
antoine	antoine
agent	agent
significantly	significativement
chancellor	chancelier
consecutive	consécutif
nucleus	noyau
grosse	grosse
please	veuillez
senate	sénat
feuille	feuille
mechanism	mécanisme
audience	audience
hotel	hôtel
true,	vrai
lightly	légèrement
operator	opérateur
missile	missile
alt	alt
ontario	ontario
foreigner	étranger
experimental	expérimental
merely	merely
versions	versions
nationals	nationaux
frequent	fréquent
herzegovina	herzégovine
brother	frère
kim	kim
essex	essex
massif	massif
frontiers	frontières
fou	fou
overall	overall
conduit	conduit
obama	obama
colonel	colonel
musicians	musiciens
strange	étrange
vegas	vegas
knight	chevalier
merchant	marchand
male	mâle
giant	géant
ivory	ivoire
diploma	diplôme
causes	causes
ss	ss
blancs	blancs
independence	indépendance
seriously	sérieusement
rule	règle
mois	mois
voyages	voyages
strategy	stratégie
baltimore	baltimore
canton	canton
challenge	défi
vehicles	véhicules
tables	tables
bonus	bonus
mathieu	mathieu
discoverer	découvreur
profile	profil
serbia	serbie
poems	poèmes
hitler	hitler
components	composants
recompense	récompense
fm	fm
wikiproject	wikiprojet
valence	valence
plane	plane
morgan	morgan
latine	latine
currents	courants
vivant	vivant
been	been
mask	masque
right	droit
recreation	récréation
\frac	\frac
christophe	christophe
parallel	parallèle
grand	grand
transit	transit
burgundy	bourgogne
avez	avez
curé	curé
theorem	théorème
republic	république
charles	charles
houston	houston
puissance	puissance
populaires	populaires
asteroid	astéroïde
windows	fenêtres
toile	toile
advertisement	publicité
costs	coûts
copy	copie
server	serveur
cardinal	cardinal
sugar	sucre
pronunciation	prononciation
dating	dating
tanks	tanks
declined	décliné
fra	fra
education,	éducation
actor	acteur
façade	façade
probably	probablement
blanche	blanche
boat	bateau
commissioned	commissionné
provenance	provenance
ohio	ohio
affiliated	affilié
orientation	orientation
violent	violent
hong	hong
justice	justice
consecrated	consacré
communist	communiste
manchester	manchester
alleged	allégué
union	union
jaune	jaune
tradition	tradition
clermont	clermont
plaisir	plaisir
hierarchy	hiérarchie
procedure	procédure
leonard	leonard
adaptation	adaptation
partout	partout
here	ici
xavier	xavier
norfolk	norfolk
seattle	seattle
pirates	pirates
errors	erreurs
idaho	idaho
gothic	gothique
resistance	résistance
jim	jim
peru	pérou
somerset	somerset
franklin	franklin
phase	phase
botanique	botanique
landscape	paysage
audio	audio
precedent	précédent
better	mieux
egyptian	égyptien
architectural	architectural
capable	capable
useful	utile
contract	contrat
tue	tue
extremely	extrêmement
wiki	wiki
demonstrated	démontré
murphy	murphy
identity	identité
error	erreur
fiat	fiat
contributions	contributions
treaties	traités
crimes	crimes
abu	abu
serb	serbe
julie	julie
contribution	contribution
choir	chœur
ameliorate	améliorer
catalogue	catalogue
produits	produits
territoriale	territoriale
ambassador	ambassadeur
liens	liens
informatics	informatique
identical	identique
exercise	exercice
yves	yves
consumption	consommation
photographies	photographies
guide	guide
puissant	puissant
overs	overs
sombre	sombre
aimed	aimé
hampshire	hampshire
delaware	delaware
orthography	orthographe
match	match
calendar	calendrier
conception	conception
terminal	terminal
manhattan	manhattan
connected	connecté
roussillon	roussillon
amorous	amoureux
minnesota	minnesota
bonjour	bonjour
kentucky	kentucky
galles	galles
essays	essais
homage	hommage
ny	ny
comedy	comédie
winter	hiver
marriage	mariage
