universal	universale
johnny	johnny
capito	capito
league	lega
tue	tue
stanley	stanley
war	guerra
difficult	difficile
knight	cavaliere
prefecture	prefettura
capacious	capace
light	luce
largo	largo
claudio	claudio
athletics	atletica
lots	lots
shakespeare	shakespeare
amica	amica
relationships	relazioni
empire	impero
lakes	laghi
sovereign	sovrano
northern	settentrionale
pena	pena
alternative	alternativa
denver	denver
banks	banche
piacenza	piacenza
visit	visita
amsterdam	amsterdam
fields	campi
executive	esecutivo
signal	segnale
substitute	sostituto
difficulty	difficoltà
armando	armando
exclusively	esclusivamente
predecessor	predecessore
declined	declinato
antique	antico
hungarian	ungherese
friends	amici
road,	strada
tables	tavoli
cyclist	ciclista
mention	menzione
alumni	alunni
focus	focus
navigation	navigazione
polo	polo
taranto	taranto
interiors	interni
property	proprietà
block	blocco
spanish	spagnolo
contract	contratto
interesting	interessante
bodies	corpi
contribution	contribuzione
explanation	spiegazione
org/w/index	org/w/index
fra	fra
positions	posizioni
service	servizio
ecliptic	eclittica
france	francia
cbs	cbs
azure	azzurro
interior	interno
mississippi	mississippi
infantry	fanteria
yugoslavia	jugoslavia
detroit	detroit
seriously	seriamente
annual	annuale
apart	apart
days	giorni
mythology	mitologia
characters	caratteri
castle	castello
billy	billy
quarter	quarto
rocky	roccioso
launched	lanciato
continental	continentale
planes	piani
commons	commons
actors	attori
berlin	berlino
roles	ruoli
queen	regina
elementary	elementare
giant	gigante
irish	irlandese
nepal	nepal
communications	comunicazioni
address	indirizzo
eliminated	eliminato
missouri	missouri
institute	istituto
family	famiglia
small	piccolo
citations	citazioni
unico	unico
depression	depressione
occasion	occasione
regional	regionale
license	licenza
destroyed	distrutto
ghost	fantasma
operator	operatore
discourse	discorso
naval	navale
costumes	costumi
zone	zona
specialty	specialità
las	las
damages	danni
citizens	cittadini
independent	indipendente
todd	todd
technique	tecnica
architectures	architetture
third	terzo
clay	argilla
color	colore
modified	modificato
dean	decano
construction	costruzione
docent	docente
baroque	barocco
tennessee	tennessee
michel	michel
interpreters	interpreti
emphasis	emphasis
involvement	coinvolgimento
sino	sino
pacifico	pacifico
tokyo	tokyo
doubts	dubbi
ferdinando	ferdinando
evolution	evoluzione
more	piu
water	acqua
variant	variante
norwegian	norvegese
garden	giardino
abandonment	abbandono
meno	meno
maintained	mantenuto
even	even
statistics	statistiche
interested	interessato
saturday	sabato
simply	semplicemente
document	documento
analysis	analisi
platforms	piattaforme
monuments	monumenti
matrix	matrice
comedy	commedia
design	disegno
actresses	attrici
audio	audio
charge	carica
jane	jane
kentucky	kentucky
constituted	costituito
park	parco
promotional	promozionale
department	dipartimento
request	richiesta
battery	batteria
centrales	centrali
seattle	seattle
egypt	egitto
names	nomi
dubber	doppiatore
field	campo
solamente	solamente
nuove	nuove
acid	acido
position	posizione
commentary	commento
episcopal	episcopale
price	prezzo
scuro	scuro
malaysia	malaysia
dry	asciutto
controversial	controversial
territories	territori
sebastiano	sebastiano
lanka	lanka
gian	gian
nei	nei
user	utente
russell	russell
civil	civile
rich	ricco
syria	siria
windows	finestre
necessary	necessario
employment	impiego
jerusalem	gerusalemme
stars	stelle
bridges	ponti
body	corpo
delivery	consegna
spectacle	spettacolo
lgbt	lgbt
puglia	puglia
josé	josé
moore	moore
during	durante
clubnat	clubnat
aspects	aspetti
bird	uccello
ferro	ferro
wang	wang
elected	eletto
finishing	finishing
peoples	popoli
probability	probabilità
michigan	michigan
implementation	implementazione
dimensions	dimensioni
colorado	colorado
defensive	difensivo
ott	ott
catholics	cattolici
confederation	confederazione
favourable	favorevole
contact	contatto
wellington	wellington
aldo	aldo
chords	accordi
hindu	hindu
preserved	conservato
duty	dovere
after	dopo
wolf	lupo
mechanical	meccanico
ultimately	ultimamente
bryan	bryan
clearly	chiaramente
championships	campionati
super	super
immediate	immediato
scudo	scudo
isabella	isabella
reception	ricevimento
rolling	rolling
population	popolazione
judgement	giudizio
buddhist	buddhista
sung	cantato
improvement	miglioramento
donald	donald
volo	volo
liberty	libertà
two	due
dragon	drago
principal	principale
officer	ufficiale
sequence	sequenza
command	comando
oblast	oblast
experiences	esperienze
fabrizio	fabrizio
paolo	paolo
chivalry	cavalleria
panorama	panorama
quantity	quantità
circa	circa
committee	comitato
manifestations	manifestazioni
teaching	insegnamento
landscape	paesaggio
february	febbraio
played	giocato
port	porto
kansas	kansas
clement	clemente
psychology	psicologia
accompanied	accompagnato
tomb	tomba
characteristics	caratteristiche
seasons	stagioni
victorian	vittoriano
literary	letterario
code	codice
wine	vino
tropical	tropicale
blocked	bloccato
superior	superiore
einaudi	einaudi
valleys	valli
interests	interessi
resources	risorse
creator	creatore
cannot	cannot
objectives	obiettivi
concepts	concetti
calculated	calcolato
count	conta
recognition	riconoscimento
cousin	cugino
inscription	iscrizione
advantage	vantaggio
votes	voti
singular	singolare
oh	oh
stations	stazioni
target	bersaglio
sera	sera
kenya	kenya
conservation	conservazione
catholic	cattolico
clark	clark
players	giocatori
divided	diviso
hands	mani
tours	tours
cross	croce
assistant	aiutante
modena	modena
energy	energia
saw	sega
law	legge
portion	porzione
flat	flat
submission	sottomissione
moon	luna
configuration	configurazione
spaces	spazi
cultural	culturale
physicist	fisico
doctrine	dottrina
numbers	numeri
daniel	daniele
anderson	anderson
vladimir	vladimir
facebook	facebook
hemisphere	emisfero
poet	poeta
offer	offerta
england	inghilterra
trinity	trinità
lessons	lezioni
socio	socio
norma	norma
doctor	dottore
subspecies	sottospecie
favorite	preferito
operative	operativo
married	sposato
fuel	carburante
laws	leggi
church	chiesa
presidents	presidenti
confused	confuso
minutes	minuti
existence	esistenza
cincinnati	cincinnati
allies	alleati
dante	dante
change	cambiamento
truth	verità
who	chi
animal	animale
week	settimana
human	umano
fermo	fermo
too	troppo
symbol	simbolo
governors	governatori
gothic	gotico
typology	tipologia
blp	blp
horror	orrore
half	metà
mexico	messico
influenza	influenza
senator	senatore
rotation	rotazione
acts	atti
memory	memoria
planned	pianificato
legitimate	legittimo
sculpture	scultura
condition	condizione
terminal	terminale
intervention	intervento
sony	sony
adelaide	adelaide
collections	collezioni
disaster	disastro
sorta	sorta
archbishop	arcivescovo
martin	martin
phoenix	fenice
manca	manca
orbit	orbita
rami	rami
christ	cristo
morto	morto
additions	aggiunte
linear	lineare
gordon	gordon
rules	regole
friendly	amichevole
vai	vai
editing	editing
scenarist	sceneggiatore
pianist	pianista
category	categoria
utah	utah
successful	successful
fundamental	fondamentale
matrimony	matrimonio
rango	rango
caterina	caterina
painting	pittura
restrictions	restrizioni
apparition	apparizione
montreal	montreal
maria	maria
vegas	vegas
values	valori
polacca	polacca
laboratory	laboratorio
municipal	municipale
wikipedians	wikipediani
battle	battaglia
qualification	qualificazione
persian	persiano
institution	istituzione
reconstruction	ricostruzione
lover	amante
trio	trio
systems	sistemi
criticisms	critiche
shade	ombra
basilica	basilica
founder	fondatore
messina	messina
mba	mba
president	presidente
specifico	specifico
mission	missione
bishops	vescovi
capital	capitale
four	quattro
trace	traccia
reduction	riduzione
sonora	sonora
keyboard	tastiera
soprano	soprano
system	sistema
classic	classico
rosse	rosse
tribute	tributo
victims	vittime
gallery	galleria
lincoln	lincoln
dominion	dominio
kerala	kerala
•	•
foreigners	stranieri
maryland	maryland
championship	campionato
origin	origine
traffic	traffico
salerno	salerno
pine	pino
ministry	ministero
guidance	guidance
riga	riga
it	it
auckland	auckland
seminary	seminario
organizations	organizzazioni
earthquake	terremoto
potenza	potenza
really	davvero
tigers	tigri
comics	fumetti
solo	solo
croatian	croato
college	college
intention	intenzione
census	censimento
background	sfondo
requested	richiesto
conception	concezione
wilson	wilson
democrats	democratici
professional	professionista
exit	uscita
posterior	posteriore
possible	possibile
won	vinse
warsaw	varsavia
management	gestione
november	novembre
weak	debole
diffusion	diffusione
serra	serra
joan	joan
athlete	atleta
venice	venezia
option	opzione
christmas	natale
pablo	pablo
companion	compagno
elements	elementi
saints	santi
sentence	sentenza
encyclopedic	enciclopedico
dreams	sogni
infinity	infinito
possibility	possibilità
bands	bands
choruses	cori
removal	rimozione
bed	letto
elsewhere	altrove
muslim	musulmano
monks	monaci
arabs	arabi
spam	spam
defender	difensore
biological	biologico
americana	americana
madonna	madonna
referrals	riferimenti
ramo	ramo
broadway	broadway
thesis	tesi
treaties	trattati
revolution	rivoluzione
sold	venduto
bachelor	bachelor
leeds	leeds
coffee	caffè
percussions	percussioni
partially	parzialmente
programmes	programmi
warned	avvertito
victim	vittima
matthew	matteo
giants	giganti
virgin	vergine
evidence	evidenza
candidacy	candidatura
emma	emma
thirty	trenta
rimini	rimini
without	senza
wood	legno
newspapers	giornali
japan	giappone
protest	protesta
brain	cervello
adventures	avventure
crater	cratere
ducato	ducato
dutch	olandese
inspiration	ispirazione
words	parole
hughes	hughes
scientists	scienziati
patients	pazienti
cause	causa
iran	iran
autumn	autunno
morale	morale
latino	latino
terrain	terreno
consiglio	consiglio
entity	entità
familiar	familiare
serbo	serbo
constellation	costellazione
flora	flora
period	periodo
van	furgone
thai	thai
candidates	candidati
stadium	stadio
raymond	raimondo
passo	passo
beings	esseri
communication	comunicazione
iowa	iowa
essentially	essenzialmente
string	stringa
essays	saggi
sculptor	scultore
measure	misura
rail	rail
measures	misure
calibre	calibro
cat	gatto
faithful	fedele
experience	esperienza
punk	punk
assai	assai
medicine	medicina
rogers	rogers
reds	rossi
titles	titoli
arrest	arresto
manufacturers	manufacturers
successes	successi
protein	proteina
much	molto
mother	mamma
sale	vendita
jurisdiction	giurisdizione
legislation	legislazione
courier	corriere
fusion	fusione
reservoir	serbatoio
andrea	andrea
responsible	responsabile
accepted	accettato
distribution	distribuzione
sc	sc
delta	delta
need	bisogno
bishop	vescovo
sentiments	sentimenti
scotland	scozia
reason	ragione
usa	usa
leagues	leghe
conversion	conversione
cricket	cricket
desert	deserto
pop	pop
criteria	criteri
milan	milano
pious	pio
milanese	milanese
enormous	enorme
bergamo	bergamo
message	messaggio
general	generale
trees	alberi
contested	contestato
meat	carne
particularly	particolarmente
roma	roma
presence	presenza
regulations	regolamenti
acceptable	accettabile
homework	compiti
hospital	ospedale
garibaldi	garibaldi
designation	designazione
enterprises	imprese
url	url
created	creato
tennis	tennis
org/wiki/	org/wiki/
registration	registrazione
bangladesh	bangladesh
mitchell	mitchell
museums	musei
summoned	convocato
weeks	settimane
raw	crudo
protagonists	protagonisti
villages	villaggi
commercial	commerciale
satellite	satellite
mille	mille
chapters	capitoli
confederate	confederato
racing	racing
patient	paziente
sulle	sulle
wayne	wayne
conflict	conflitto
fighting	fighting
requisites	requisiti
massachusetts	massachusetts
improved	migliorato
verona	verona
sull	sull
dvd	dvd
self	self
proprietor	proprietario
politicians	politici
jordan	giordano
dublin	dublino
patrimony	patrimonio
guests	ospiti
april	aprile
transition	transizione
seed	seme
blues	blues
material	materiale
trains	treni
architects	architetti
bases	basi
bambina	bambina
examination	esame
roman	romano
launch	lancio
fief	feudo
danny	danny
streets	strade
useless	inutile
able	abile
signora	signora
driven	driven
normally	normalmente
mirror	specchio
nostro	nostro
palm	palma
veloce	veloce
flow	flusso
otherwise	altrimenti
chemistry	chimica
pistol	pistola
stemma	stemma
glasgow	glasgow
africa	africa
scientific	scientifico
thailand	thailand
cooperation	cooperazione
lorena	lorena
evident	evidente
palaces	palazzi
homicide	omicidio
constitution	costituzione
christianity	cristianesimo
heart	cuore
insurance	assicurazione
jon	jon
thomas	tommaso
livorno	livorno
meadow	prato
rooster	gallo
player	giocatore
ethnic	etnico
legacy	legacy
pearl	perla
roberto	roberto
viola	viola
arthur	arthur
afd	afd
probably	probabilmente
electronic	elettronico
miguel	miguel
alcohol	alcol
leadership	leadership
secret	segreto
parameters	parametri
tony	tony
semifinal	semifinale
alexander	alessandro
kim	kim
rose	rosa
traits	tratti
distinguished	distinto
class	classe
bonus	bonus
impossible	impossibile
stable	stabile
palestine	palestina
hamilton	hamilton
allora	allora
gravely	gravemente
connections	connessioni
magazines	riviste
value	valore
co	co
circle	cerchio
bank	banca
state	stato
poverty	povertà
canto	canto
parochial	parrocchiale
successor	successore
tone	tono
interna	interna
nature	natura
http	http
submarine	sottomarino
monument	monumento
sixty	sessanta
rd	rd
crystal	cristallo
maine	maine
arizona	arizona
technicians	tecnici
volume	volume
gabriele	gabriele
photo	foto
symphony	sinfonia
control	controllo
baseball	baseball
particulars	particolari
towers	torri
pennsylvania	pennsylvania
sex	sesso
century	secolo
manual	manuale
excuse	scusa
revolutionary	rivoluzionario
textile	tessuto
fountain	fontana
paola	paola
venezuela	venezuela
false	falso
rock	roccia
could	potrebbe
nelson	nelson
lead	piombo
insertion	inserimento
letter	lettera
theater	teatro
mauro	mauro
rush	rush
corse	corse
structures	strutture
page	pagina
archives	archivi
tube	tubo
vatican	vaticano
default	default
miniseries	miniserie
antarctic	antartico
feat	feat
salvation	salvezza
entrepreneur	imprenditore
neutral	neutrale
exactly	esattamente
twelve	dodici
materials	materiali
socialist	socialista
stories	storie
tal	tal
melbourne	melbourne
corner	angolo
lost	perduto
suspended	sospeso
limited	limitato
hollywood	hollywood
guards	guardie
locals	locali
populated	popolato
regular	regolare
obama	obama
european	europeo
howard	howard
integrated	integrato
west	ovest
signore	signore
accused	accusato
partnership	partnership
reserve	riserva
hotel	albergo
effect	effetto
california	california
espresso	espresso
spectators	spettatori
spirit	spirito
noise	rumore
solar	solare
helium	elio
nephew	nipote
result	risultato
lombardy	lombardia
savoy	savoia
catania	catania
definitively	definitivamente
formula	formula
return	ritorno
aperture	apertura
style	stile
symbols	simboli
violent	violento
blogspot	blogspot
saga	saga
site	sito
discs	dischi
alto	alto
bride	sposa
execution	esecuzione
suicide	suicidio
quarters	quartieri
bassist	bassista
mountain	montagna
abbey	abbazia
cielo	cielo
needs	bisogni
climate	clima
taiwan	taiwan
cathedral	cattedrale
australia	australia
iranian	iraniano
passenger	passeggero
ukrainian	ucraino
winner	vincitore
lions	leoni
minister	ministro
contributor	contributore
incidents	incidenti
beat	battito
and/or	e/o
practical	pratico
chitarra	chitarra
participation	partecipazione
lawyers	avvocati
nel	nel
options	opzioni
salvatore	salvatore
warren	warren
secretary	segretario
basket	basket
course	percorso
drugs	droghe
strike	sciopero
barcelona	barcellona
approach	avvicinamento
musician	musicista
tiro	tiro
syracuse	siracusa
clear	chiaro
production	produzione
locality	località
principality	principato
attack	attacco
landing	atterraggio
guinea	guinea
sea	mare
administrators	amministratori
application	applicazione
commonwealth	commonwealth
tommy	tommy
square	quadrato
addition	aggiunta
walker	camminatore
letters	lettere
prisoners	prigionieri
diseases	malattie
douglas	douglas
profession	professione
spiritual	spirituale
profundity	profondità
circuit	circuito
fuga	fuga
transfer	trasferimento
head	testa
unfortunately	sfortunatamente
adapted	adattato
franco	franco
point	punto
favor	favore
helena	elena
sand	sabbia
visited	visitato
conclusion	conclusione
religion	religione
norms	norme
detective	detective
prince	principe
certain	certo
colombia	colombia
partisan	partigiano
keyboards	tastiere
subdivision	suddivisione
offensive	offensivo
probable	probabile
native	nativo
singers	cantanti
term	termine
bruce	bruce
physics	fisica
organ	organo
regiment	reggimento
arch	arco
data	dati
fresco	affresco
romanized	romanizzato
available	disponibile
familiars	familiari
valley	valle
heroes	eroi
versions	versioni
norway	norvegia
hope	speranza
affirmation	affermazione
directors	direttori
hoax	hoax
leonardo	leonardo
artillery	artiglieria
jpg	jpg
face	faccia
offered	offerto
churches	chiese
demonstrated	dimostrato
exile	esilio
employee	impiegato
net	rete
leaves	foglie
superiors	superiori
science	scienza
honor	onore
commanded	comandato
gold	oro
fox	volpe
reso	reso
olympiad	olimpiade
hero	eroe
nets	reti
editions	edizioni
states	stati
hypothesis	ipotesi
fabio	fabio
federale	federale
original	originale
album	album
decision	decisione
birds	uccelli
liverpool	liverpool
contrary	contrario
schema	schema
economical	economico
success	successo
goddess	dea
government	governo
use	uso
space	spazio
nino	nino
niccolò	niccolò
stack	stack
pilot	pilota
metropolitan	metropolitano
decisions	decisioni
monica	monica
jones	jones
effectively	effettivamente
screenplay	sceneggiatura
piero	piero
map	mappa
beaten	battuto
whoever	chiunque
atp	atp
genetic	genetico
sock	calzino
verso	verso
university	università
indonesia	indonesia
man	uomo
area	area
through	through
effective	effettivo
julian	giuliano
nation	nazione
feast	festa
divinity	divinità
internationally	internazionalmente
support	sostegno
thoughts	pensieri
croatia	croazia
ambassador	ambasciatore
length	lunghezza
acted	acted
art	arte
negative	negativo
rgb	rgb
hill	collina
guide	guida
florida	florida
online	online
formally	formalmente
hand	mano
motive	motivo
river	fiume
horse	cavallo
manga	manga
functioning	funzionamento
formal	formale
visitors	visitatori
closure	chiusura
conservative	conservatore
editorial	editoriale
nove	nove
arches	archi
restored	ripristinato
generals	generali
rocco	rocco
situation	situazione
filo	filo
cannon	cannone
lion	leone
real	reale
moving	moving
bring	bring
jesus	gesù
hudson	hudson
dawn	alba
vision	visione
ernesto	ernesto
gaetano	gaetano
daughters	figlie
musical	musicale
gray	grigio
joe	joe
documentary	documentario
chair	sedia
gain	guadagno
testimonies	testimonianze
cover	copertina
lights	luci
countryside	campagna
poland	polonia
duties	doveri
voices	voci
administrative	amministrativo
million	milione
uefa	uefa
sé	sé
literature	letteratura
es	es
front	fronte
publication	pubblicazione
mute	muto
davis	davis
forward	avanti
affairs	affari
jul	jul
bear	orso
alpha	alpha
confusion	confusione
jerome	girolamo
subdivided	suddiviso
true,	vero
might	might
song	canzone
news	notizie
broadcast	broadcast
rivers	fiumi
martyr	martire
instituted	istituito
officially	ufficialmente
classification	classificazione
contemporary	contemporaneo
entirely	entirely
autonomous	autonoma
capo	capo
sarah	sarah
domestic	domestico
minute	minuto
objects	oggetti
signori	signori
initiative	iniziativa
agent	agente
no	no
notwithstanding	nonostante
adjacent	adjacent
liberal	liberale
berkeley	berkeley
thompson	thompson
piazza	piazza
cambridge	cambridge
they	essi
consequent	conseguente
skin	pelle
strongly	strongly
contemporaneously	contemporaneamente
dick	dick
concept	concetto
different	differente
counselor	consigliere
vapor	vapore
serious	serio
apparently	apparentemente
populations	popolazioni
johann	johann
frederick	federico
differences	differenze
popularity	popolarità
clothing	abbigliamento
organic	organico
photography	fotografia
saudi	saudita
infrastructure	infrastruttura
journalists	giornalisti
platinum	platino
variations	variazioni
absolute	assoluto
blood	sangue
conflicts	conflitti
ring	anello
assigned	assegnato
him	lui
manchester	manchester
decades	decenni
theatrical	teatrale
ossia	ossia
stare	stare
institutions	istituzioni
opposite	opposto
peru	perù
nigeria	nigeria
expression	espressione
hebraic	ebraico
aspx	aspx
daisy	margherita
copies	copie
siege	assedio
principals	principali
eligible	eleggibile
development	sviluppo
causing	causando
walter	walter
newton	newton
denis	denis
creative	creativo
consumer	consumatore
affair	affare
post	posta
transformation	trasformazione
japanese	giapponese
dio	dio
reality	realtà
waves	onde
movement	movimento
implemented	implementato
chess	scacchi
motives	motivi
indoor	indoor
motivations	motivazioni
louis	louis
description	descrizione
violation	violazione
spider	ragno
atlanta	atlanta
moves	moves
regions	regioni
acoustic	acustico
actions	azioni
volleyball	pallavolo
raised	alzato
naturali	naturali
son	figlio
appointment	appuntamento
resistance	resistenza
cap	cappello
sa	sa
benefit	beneficio
maschio	maschio
expired	scaduto
ivan	ivan
modality	modalità
florentine	fiorentina
phase	fase
destro	destro
complex	complesso
techniques	tecniche
directly	direttamente
substances	sostanze
plants	piante
while	mentre
element	elemento
sponsored	sponsorizzato
sente	sente
discipline	disciplina
teacher	insegnante
cycle	ciclo
copia	copia
julia	giulia
departments	dipartimenti
village	villaggio
robin	robin
synthesis	sintesi
meta	meta
courses	corsi
eventual	eventuale
missions	missioni
authors	autori
kick	kick
christina	cristina
released	rilasciato
convent	convento
signed	firmato
monk	monaco
student	studente
inclusion	inclusione
historians	storici
finale	finale
eugenio	eugenio
cited	citato
resignations	dimissioni
alps	alpi
concerning	concerning
sister	sorella
cook	cuoco
drama	dramma
social	sociale
girl	ragazza
angel	angelo
province	provincia
nations	nazioni
hurricane	uragano
gianfranco	gianfranco
partita	partita
deputies	deputati
rocks	rocce
lieutenant	luogotenente
bears	orsi
determine	determinare
parliament	parlamento
component	componente
umberto	umberto
circumstances	circostanze
morgan	morgan
scotsman	scozzese
sponsor	sponsor
occidental	occidentale
harrison	harrison
antonio	antonio
mill	mulino
publics	pubblici
origins	origini
calculation	calcolo
paul	paul
philip	filippo
brothers	fratelli
coaching	coaching
bambino	bambino
suburb	sobborgo
fossils	fossili
altar	altare
sounds	suoni
concentration	concentrazione
constitutional	costituzionale
videogames	videogiochi
exhibition	esposizione
spring	primavera
protection	protezione
bat	pipistrello
orleans	orleans
uniform	uniforme
aviation	aviazione
minority	minoranza
rival	rivale
convention	convenzione
poor	povero
facility	facilità
objective	obiettivo
academy	accademia
merchant	mercante
les	les
cost	costo
chan	chan
something	qualcosa
gene	gene
trento	trento
op	op
revision	revisione
admiral	ammiraglio
memorial	memoriale
newcastle	newcastle
consumption	consumo
incorporated	incorporato
opinion	opinione
democracy	democrazia
tiene	tiene
casi	casi
volte	volte
crisis	crisi
studios	studios
artificial	artificiale
article	articolo
restaurants	ristoranti
wife	moglie
animation	animazione
sweden	svezia
advocate	avvocato
increase	aumento
dover	dover
remote	remoto
right	diritto
meridional	meridionale
types	tipi
temporary	temporaneo
stand	stand
motivation	motivazione
musicians	musicisti
decree	decreto
epoch	epoca
jun	jun
colleague	collega
writings	scritture
dimension	dimensione
fatto	fatto
vigor	vigore
perfectly	perfettamente
mediterranean	mediterraneo
hospitals	ospedali
russia	russia
orchestra	orchestra
chain	catena
babies	bambini
entire	entire
periods	periodi
changes	cambiamenti
syndrome	sindrome
guest	ospite
constructions	costruzioni
potente	potente
"	"
consensus	consenso
vermont	vermont
solutions	soluzioni
frequency	frequenza
romantic	romantico
inappropriate	inappropriato
ti	ti
lucca	lucca
substance	sostanza
theme	tema
vide	vide
arriva	arriva
phenomenon	fenomeno
vasta	vasta
ciao	ciao
biology	biologia
liberation	liberazione
pokémon	pokémon
blessed	benedetto
indiana	indiana
engineers	ingegneri
credits	crediti
access	accesso
friend	amico
month	mese
presto	presto
occident	occidente
homage	omaggio
legato	legato
nothing	niente
percussion	percussione
canada	canada
modifications	modifiche
ontario	ontario
equipped	equipaggiato
working	lavorando
bull	toro
apartment	appartamento
restaurant	ristorante
input	input
joints	giunti
direction	direzione
strategy	strategia
wing	ala
resolution	risoluzione
individuals	individuali
promote	promuovere
arbiter	arbitro
wallace	wallace
characteristic	caratteristico
confirmation	conferma
hugh	hugh
distributed	distribuito
ron	ron
soccorso	soccorso
jackson	jackson
broke	broke
aeronautics	aeronautica
talent	talento
backing	backing
oscar	oscar
pseudonym	pseudonimo
projects	progetti
function	funzione
htm	htm
marina	marina
footballers	calciatori
activist	attivista
anterior	anteriore
tiger	tigre
marketing	marketing
assistance	assistenza
monthly	mensile
dave	dave
reasons	ragioni
quotidian	quotidiano
lyceum	liceo
totally	totally
breaking	breaking
achievement	achievement
notated	notato
george	giorgio
guardianship	tutela
extremely	estremamente
madrid	madrid
ligurian	ligure
carabinieri	carabinieri
initial	iniziale
republic	repubblica
miami	miami
boundaries	confini
billion	miliardo
confirmed	confermato
emilia	emilia
toronto	toronto
strategic	strategico
behavior	comportamento
potentially	potenzialmente
minnesota	minnesota
experimental	sperimentale
trained	addestrato
theories	teorie
esteem	stima
infobox	infobox
remembers	ricorda
shopping	shopping
exercise	esercizio
novelties	novità
accessible	accessibile
alfonso	alfonso
photographer	fotografo
radical	radicale
resigned	rassegnato
hair	capelli
commissioner	commissario
novecento	novecento
denmark	danimarca
vicenza	vicenza
file	file
compound	composto
botanical	botanico
reform	riforma
brother	fratello
activists	attivisti
similarly	similmente
young	giovane
succession	successione
mezzo	mezzo
security	sicurezza
compilation	compilazione
however	tuttavia
approval	approvazione
fernando	fernando
jurist	giurista
interaction	interazione
ferrara	ferrara
individual	individuale
guided	guidato
precision	precisione
eyes	occhi
vietnam	vietnam
october	ottobre
sector	settore
bass	basso
traditional	tradizionale
choir	coro
sciences	scienze
subject	soggetto
saxony	sassonia
theologian	teologo
diesel	diesel
roots	radici
francesca	francesca
expatriate	espatriato
lontano	lontano
again	again
instrument	strumento
eddie	eddie
military	militare
contributions	contribuzioni
products	prodotti
object	oggetto
product	prodotto
apparent	apparente
terry	terry
missile	missile
basa	basa
pieces	pezzi
norfolk	norfolk
criminal	criminale
composers	compositori
israel	israele
participated	partecipato
economist	economista
organized	organizzato
harris	harris
approved	approvato
passages	passaggi
autonomy	autonomia
ballet	balletto
appeal	appello
destined	destinato
union	unione
legal	legale
northwest	nordovest
cannons	cannoni
evans	evans
useful	utile
bolzano	bolzano
rizzoli	rizzoli
pitcher	pitcher
robinson	robinson
approximately	approssimativamente
relatively	relativamente
alessandria	alessandria
anyway	anyway
poetry	poesia
britannica	britannica
democratic	democratico
libera	libera
chinese	cinese
alaska	alaska
quebec	quebec
southeast	sudest
marquess	marchese
romania	romania
momento	momento
journalism	giornalismo
marcello	marcello
criticism	critica
wikimedia	wikimedia
passage	passaggio
brooklyn	brooklyn
donated	donato
spagnola	spagnola
fruit	frutta
window	finestra
paintings	dipinti
click	clicca
derby	derby
bowling	bowling
terrestre	terrestre
sessions	sessioni
argument	argomento
house	casa
assembly	assemblea
theory	teoria
battista	battista
powers	poteri
tourism	turismo
organs	organi
diego	diego
arrived	arrivato
divisa	divisa
procedure	procedura
winter	inverno
method	metodo
thank	grazie
oxford	oxford
vienna	vienna
ninth	nono
sporty	sportivo
conscience	coscienza
collaborated	collaborato
should	dovrebbe
structure	struttura
sunday	domenica
henry	henry
palestinian	palestinese
planning	pianificazione
market	mercato
band	banda
speaker	parlatore
report	rapporto
duke	duca
eye	occhio
warmth	calore
efficacious	efficace
samuel	samuel
tradition	tradizione
ocean	oceano
good	buono
belgian	belga
soldier	soldato
partial	parziale
facile	facile
naturally	naturalmente
rhode	rhode
indigenous	indigeno
iso	iso
partite	partite
armenian	armeno
realization	realizzazione
fifth	quinto
pioneer	pioniere
he	egli
card	carta
sufficient	sufficiente
tenor	tenore
scudetto	scudetto
width	larghezza
correspondent	corrispondente
luigi	luigi
statistician	statistico
simple	semplice
roll	rullo
researchers	ricercatori
oakland	oakland
diana	diana
published	pubblicato
singapore	singapore
nbc	nbc
opposition	opposizione
protected	protetto
foot	piede
jefferson	jefferson
testament	testamento
byzantine	bizantino
battalion	battaglione
name	nome
organization	organizzazione
admitted	ammesso
points	punti
georgia	georgia
beloved	amato
funds	fondi
sound	suono
experts	esperti
basis	basis
nuclear	nucleare
armato	armato
dedicated	dedicato
leaf	foglia
extreme	estremo
sullivan	sullivan
contents	contenuti
urban	urbano
charity	carità
hms	hms
appropriate	appropriato
predominantly	prevalentemente
surprise	sorpresa
elite	elite
fini	fini
apostolic	apostolico
journeys	viaggi
recent	recente
examples	esempi
gas	gas
citizen	cittadino
gardens	giardini
duration	durata
bernardo	bernardo
age	età
munich	munich
guilty	colpevole
sopra	sopra
padua	padova
texas	texas
county	contea
telephone	telefono
seven	sette
carbon	carbonio
parma	parma
latina	latina
root	radice
jose	jose
exclusive	esclusivo
deceased	deceduto
problems	problemi
ap	ap
justice	giustizia
opportunity	opportunità
dogs	cani
dal	dal
giacomo	giacomo
residency	residenza
archived	archiviato
role	ruolo
painted	dipinto
temple	tempio
faculty	facoltà
volunteer	volontario
episodes	episodi
su	su
novara	novara
immediately	immediatamente
credit	credito
workers	lavoratori
invitation	invito
botswana	botswana
form	forma
operation	operazione
costs	costi
phrase	frase
condemnation	condanna
parish	parrocchia
door	porta
forum	foro
elevated	elevato
scene	scena
appointed	appointed
declared	dichiarato
commander	comandante
orders	ordini
members	membri
importance	importanza
football	football
program	programma
screen	schermo
alabama	alabama
mainstream	mainstream
smoke	fumo
englishmen	inglesi
range	range
alberta	alberta
solid	solido
methods	metodi
cult	culto
mario	mario
continent	continente
built	costruito
kevin	kevin
abuse	abuso
paradise	paradiso
single	singolo
versus	versus
reputation	reputazione
volition	volontà
glory	gloria
achilles	achille
attached	attaccato
coast	costa
pov	pov
september	settembre
drug	droga
alex	alex
arguments	argomenti
illegal	illegale
antiquities	antichità
asteroid	asteroide
unknown	sconosciuto
panel	pannello
welcome	benvenuto
midfielder	centrocampista
precedence	precedenza
section	sezione
fifteen	quindici
suggestion	suggerimento
neil	neil
box	scatola
anonymous	anonimo
swiss	svizzero
saint	santo
red	rosso
career	carriera
decline	declino
engraved	inciso
personally	personalmente
administrator	amministratore
video	video
rarely	raramente
collective	collettivo
loan	prestito
voivodeship	voivodato
dictionary	dizionario
administration	amministrazione
difference	differenza
ice	ghiaccio
solution	soluzione
grosso	grosso
critics	critici
dream	sogno
hunt	caccia
specialized	specializzato
cups	coppe
sheffield	sheffield
enrico	enrico
existent	esistente
wisconsin	wisconsin
chapter	capitolo
truck	autocarro
beni	beni
rural	rurale
lifetime	lifetime
release	rilascio
bristol	bristol
fortune	fortuna
muslims	musulmani
luisa	luisa
regularly	regolarmente
seventh	settimo
therapy	terapia
conquest	conquista
chemist	chimico
sustained	sostenuto
green	verde
korean	coreano
discussions	discussioni
martina	martina
investment	investimento
ottoman	ottomano
basin	bacino
continuing	continuing
austin	austin
madison	madison
guitarist	chitarrista
philosophy	filosofia
possession	possesso
prize	premio
abandoned	abbandonato
gradi	gradi
myself	myself
presenta	presenta
coins	monete
electoral	elettorale
nicola	nicola
valign	valign
princess	principessa
arkansas	arkansas
basses	bassi
enemy	nemico
season	stagione
financial	finanziario
athletic	atletico
juvenile	giovanile
feminine	femminile
nebraska	nebraska
summary	riassunto
foundation	fondazione
silver	argento
germania	germania
reaction	reazione
atlantic	atlantico
roberts	roberts
bakhsh	bakhsh
genius	genio
captain	capitano
she	she
brescia	brescia
ho	ho
wheels	ruote
ab	ab
dynasty	dinastia
fiction	finzione
maintenance	manutenzione
mars	marte
americano	americano
work	lavoro
fifa	fifa
latitude	latitudine
mind	mente
europeans	europei
extinct	estinto
francisco	francisco
vacuum	vuoto
representative	rappresentante
defeat	sconfitta
fascia	fascia
pakistan	pakistan
suggestions	suggerimenti
certainly	sicuramente
mobile	mobile
composition	composizione
monster	mostro
bus	autobus
suggested	suggerito
offices	uffici
intellectual	intellettuale
broad	broad
cerca	cerca
excavations	scavi
limit	limite
flank	fianco
judges	giudici
african	africano
significant	significativo
overs	overs
competitors	concorrenti
tempo	tempo
trieste	trieste
temporal	temporale
jonathan	jonathan
sword	spada
olympic	olimpico
response	risposta
margin	margine
franklin	franklin
bosnia	bosnia
pilots	piloti
guido	guido
connected	connesso
magic	magia
segment	segmento
victories	vittorie
orlando	orlando
enemies	nemici
column	colonna
distinction	distinzione
congo	congo
active	attivo
games	giochi
sánchez	sánchez
mtv	mtv
broadcasting	broadcasting
geographic	geografico
vote	voto
score	punteggio
congressional	congressuale
hour	ora
tries	tries
gang	gang
temperature	temperatura
seal	sigillo
eliminate	eliminare
interest	interesse
presences	presenze
videoclip	videoclip
jim	jim
playstation	playstation
passi	passi
wind	vento
forse	forse
variants	varianti
squadron	squadrone
families	famiglie
turkey	tacchino
coalition	coalizione
community	comunità
catalogue	catalogo
aa	aa
memories	ricordi
federation	federazione
milwaukee	milwaukee
company	compagnia
novels	romanzi
gino	gino
//	//
movements	movimenti
railroad,	ferrovia
encounters	incontri
ordinary	ordinario
limits	limiti
ireland	irlanda
locally	localmente
alternate	alternato
champion	campione
ability	abilità
publisher	editore
doors	porte
julius	giulio
soviet	soviet
presidency	presidenza
instruction	istruzione
peril	pericolo
sydney	sydney
disappearance	scomparsa
georges	georges
flowers	fiori
tier	tier
ago	ago
food	cibo
students	studenti
turner	turner
line,	linea
electricity	elettricità
services	servizi
ludovico	ludovico
coppa	coppa
forces	forze
converted	convertito
sui	sui
relevant	rilevante
care	cura
cantone	cantone
guitars	chitarre
in	in
merit	merito
pen	penna
youtube	youtube
murray	murray
current	corrente
incident	incidente
absence	assenza
vocal	vocale
normale	normale
greatest	greatest
second	secondo
insects	insetti
weekly	settimanale
sara	sara
partners	partners
ente	ente
arbcom	arbcom
declaration	dichiarazione
rapper	rapper
artists	artisti
significantly	significativamente
adversary	avversario
candidate	candidato
noto	noto
bulgaria	bulgaria
cloud	nuvola
treasure	tesoro
natural	naturale
friedrich	friedrich
poem	poema
golf	golf
romeo	romeo
museum	museo
dispute	disputa
reshoots	riprese
singer	cantante
meglio	meglio
narra	narra
italian	italiano
internet	internet
arriving	arrivando
fragments	frammenti
orientation	orientamento
david	davide
northwestern	nordoccidentale
abu	abu
uss	uss
major	maggiore
manager	manager
coaches	coaches
writer	scrittore
cinema	cinema
events	avvenimenti
interventions	interventi
biography	biografia
harvard	harvard
andy	andy
comments	commenti
type	tipo
rocket	razzo
log	log
ohio	ohio
territory	territorio
details	dettagli
hockey	hockey
kelly	kelly
coda	coda
york	york
india	india
virtue	virtù
yes	sì
spent	speso
heir	erede
altitude	altitudine
documented	documentato
renzo	renzo
women	donne
influences	influssi
kilometers	chilometri
translation	traduzione
rosary	rosario
controversy	controversia
stage	palcoscenico
styles	stili
delaware	delaware
eleven	undici
sexual	sessuale
essex	essex
arena	arena
extremity	estremità
frequent	frequente
one	uno
restoration	ripristino
diamond	diamante
accurate	accurato
lorenzo	lorenzo
racial	razziale
sport	sport
south	sud
north	nord
belong	belong
level	livello
interface	interfaccia
departure	partenza
hardware	hardware
grammar	grammatica
just	giusto
indians	indiani
fan	tifoso
august	agosto
generation	generazione
triple	tripla
edits	edits
responsibility	responsabilità
mechanism	meccanismo
presentation	presentazione
discussion	discussione
editor	redattore
exchange	scambio
sense	senso
users	utenti
paid	paid
tito	tito
soccer	calcio
informed	informato
remnants	resti
mary	mary
denomination	denominazione
transferred	trasferito
devil	diavolo
elimination	eliminazione
variety	varietà
jay	ghiandaia
ep	ep
arrival	arrivo
nickname	soprannome
note	nota
glass	vetro
asti	asti
sr	sr
americans	americani
architect	architetto
afghanistan	afghanistan
bronze	bronzo
sign	segno
jury	giuria
pakistani	pakistani
agriculture	agricoltura
argentinian	argentino
out	fuori
civilization	civiltà
wall	muro
june	giugno
shop	negozio
marco	marco
concerto	concerto
authority	autorità
assassin	assassino
adults	adulti
dating	dating
kong	kong
beijing	beijing
phases	fasi
regulation	regolamento
factor	fattore
enlargement	ampliamento
fairly	fairly
surface	superficie
equal	uguale
animals	animali
arrangement	arrangiamento
judge	giudice
obvious	ovvio
title	titolo
association	associazione
sofia	sofia
dennis	dennis
personality	personalità
losses	perdite
outdoor	outdoor
intelligence	intelligenza
expansion	espansione
serbia	serbia
promotion	promozione
commerce	commercio
pedro	pedro
houston	houston
beer	birra
khan	khan
transmission	trasmissione
disposition	disposizione
settlement	insediamento
defense	difesa
touring	touring
homonym	omonimo
elevation	elevazione
view	vista
sanctuary	santuario
atmosphere	atmosfera
id	id
maritime	marittimo
percentage	percentuale
mise	mise
hugo	hugo
monitored	monitorato
dallas	dallas
indian	indiano
australian	australiano
expedition	spedizione
athletes	atleti
andré	andré
patriot	patriota
airport	aeroporto
horses	cavalli
machine	macchina
maximum	massimo
expert	esperto
balance	bilanciamento
vito	vito
consistent	consistente
journalist	giornalista
transport	trasporto
legs	gambe
byte	byte
profound	profondo
bible	bibbia
lloyd	lloyd
policies	politiche
forced	forzato
sta	sta
motor	motore
jimmy	jimmy
establishment	establishment
friendship	amicizia
love	amore
occasionally	occasionalmente
piano	pianoforte
spaniards	spagnoli
wikipedia	wikipedia
risk	rischio
controlled	controllato
anniversary	anniversario
ball	pallone
communist	comunista
automatically	automaticamente
collins	collins
manor	maniero
star	stella
calabria	calabria
decisively	decisamente
alive	vivo
resort	resort
passa	passa
wheel	ruota
yorkshire	yorkshire
agency	agenzia
absolutely	assolutamente
contrast	contrasto
tasso	tasso
scheme	scheme
nom	nom
poets	poeti
necessarily	necessariamente
consequence	conseguenza
basketball	pallacanestro
island	isola
encouraged	incoraggiato
force	forza
gianni	gianni
therefore	perciò
proposal	proposta
portal	portale
debate	dibattito
cagliari	cagliari
agents	agenti
daughter	figlia
help,	aiuto
station	stazione
grandfather	nonno
fatherland	patria
qualifying	qualificante
changed	cambiato
introduction	introduzione
remembrance	ricordo
ford	guado
senators	senatori
congregation	congregazione
quality	qualità
sinister	sinistro
patent	brevetto
legislative	legislativo
renato	renato
ettore	ettore
cantata	cantata
timestamp	timestamp
interview	intervista
universitario	universitario
tax	tassa
injured	injured
moments	momenti
communal	comunale
religious	religioso
mounted	mounted
targa	targa
personal	personale
caribbean	caraibico
calendar	calendario
colle	colle
localization	localizzazione
accede	accedere
faces	facce
sierra	sierra
profile	profilo
action	azione
richmond	richmond
themes	temi
truppe	truppe
january	gennaio
america	america
open	aperto
boxes	scatole
instrumental	strumentale
destruction	distruzione
coach	allenatore
battuta	battuta
lie	menzogna
substantially	sostanzialmente
budapest	budapest
presbyter	presbitero
cemetery	cimitero
victory	vittoria
enterprise	impresa
castles	castelli
impact	impatto
retrocession	retrocessione
philadelphia	filadelfia
around	intorno
ryan	ryan
mandate	mandato
alta	alta
occupied	occupato
been	been
six	sei
velocity	velocità
nationality	nazionalità
lecce	lecce
geography	geografia
cleveland	cleveland
the	il
representatives	rappresentanti
watson	watson
ginevra	ginevra
chorea	corea
angels	angeli
alice	alice
tanti	tanti
vincenzo	vincenzo
nationals	nazionali
prepared	prepared
stone	pietra
rick	rick
tea	tè
parks	parchi
du	du
inhabited	abitato
mixed	mescolato
adaptation	adattamento
mathematician	matematico
ukraine	ucraina
\frac	\frac
effects	effetti
corona	corona
essential	essenziale
identity	identità
tribe	tribù
grande	grande
classics	classici
tournaments	tornei
minima	minima
potential	potenziale
williams	williams
italy	italia
parent	genitore
albanian	albanese
loneos	loneos
army	esercito
violin	violino
somerset	somerset
professor	professore
harvey	harvey
attractions	attrazioni
permanent	permanente
columbia	columbia
rebellion	ribellione
edition	edizione
unity	unità
alignbars	alignbars
aosta	aosta
historic	storico
liquid	liquido
susan	susan
arab	arabo
shanghai	shanghai
prototype	prototipo
definition	definizione
lebanon	libano
christian	cristiano
beam	beam
forests	foreste
distance	distanza
udine	udine
inferno	inferno
a	a
book	libro
riccardo	riccardo
dependents	dipendenti
pittsburgh	pittsburgh
patrol	pattuglia
fellows	fellows
ted	ted
terrains	terreni
utility	utilità
future	futuro
washington	washington
density	densità
proprio	proprio
pressure	pressione
vancouver	vancouver
friday	venerdì
congress	congresso
murphy	murphy
when	quando
diplomatic	diplomatico
territorial	territoriale
operations	operazioni
bibliography	bibliografia
weapon	arma
pari	pari
perugia	perugia
long	lungo
motors	motori
stanford	stanford
scott	scott
evening	serata
islands	isole
internazionali	internazionali
alfa	alfa
ulterior	ulteriore
those	quei
minor	minore
legend	leggenda
te	te
orange	arancio
lire	lire
immigration	immigrazione
or	or
experienced	experienced
perspective	prospettiva
behalf	behalf
chronology	cronologia
celebre	celebre
engineering	ingegneria
maps	mappe
applications	applicazioni
particular	particolare
eighty	ottanta
emilio	emilio
legion	legione
imperial	imperiale
baron	barone
columns	colonne
throne	trono
comic	fumetto
waters	acque
marker	marcatore
programming	programmazione
governor	governatore
retreat	ritirata
rule	regola
hitler	hitler
decade	decennio
sections	sezioni
competitive	competitivo
word	parola
sixth	sesto
provincial	provinciale
determined	determinato
interpretation	interpretazione
kennedy	kennedy
pure	puro
vv	vv
technologies	tecnologie
decorations	decorazioni
industry	industria
naples	napoli
both	entrambi
fa	fa
parenthesis	parentesi
searching	searching
toward	toward
canals	canali
complete	completo
ravenna	ravenna
center	centro
yellow	giallo
ita	ita
hampshire	hampshire
inaugurated	inaugurato
carolina	carolina
portugal	portogallo
sardinia	sardegna
theology	teologia
herb	erba
bassa	bassa
frescoes	affreschi
globe	globo
flag	bandiera
fundamentals	fondamentali
jacob	giacobbe
occupation	occupazione
correspondence	corrispondenza
emanuele	emanuele
coastal	costiero
passengers	passeggeri
collection	collezione
celtic	celtico
suffering	sofferenza
precedents	precedenti
grace	grazia
tension	tensione
composer	compositore
software	software
centuries	secoli
alberto	alberto
treatment	trattamento
danish	danese
relative	relativo
sultan	sultano
oriental	orientale
productions	produzioni
masters	maestri
total	totale
touchdown	touchdown
elaboration	elaborazione
associations	associazioni
adult	adulto
continued	continuato
year	anno
present	presente
school,	scuola
russo	russo
investigations	indagini
instructions	istruzioni
men	uomini
vandalism	vandalismo
residential	residenziale
labels	etichette
technology	tecnologia
feet	piedi
destiny	destino
senate	senato
tom	tom
encyclopedia	enciclopedia
massif	massiccio
resource	risorsa
fish	pesce
immigrants	immigranti
downtown	downtown
cancellata	cancellata
gregorio	gregorio
reader	lettore
beauty	beauty
sum	somma
books	libri
dominated	dominato
precedent	precedente
filmography	filmografia
torrent	torrente
rights	diritti
said	detto
formation	formazione
citation	citazione
ferrari	ferrari
index	indice
colonel	colonnello
issue	issue
hunter	cacciatore
nato	nato
attacks	attacchi
film	pellicola
alfredo	alfredo
proposals	proposte
pages	pagine
anna	anna
white	bianco
kingdom	regno
special	speciale
pavia	pavia
charged	charged
invasion	invasione
private	privato
progressive	progressivo
wickets	wickets
successive	successivo
nulla	nulla
studio	studio
episode	episodio
influence	influsso
writers	scrittori
attempted	tentato
radar	radar
musicals	musicali
extension	estensione
tongue	lingua
mantua	mantova
diocese	diocesi
progress	progresso
pirates	pirati
videogame	videogioco
gary	gary
colony	colonia
opinions	opinioni
libretto	libretto
fire	fuoco
criticized	criticato
founded	fondato
morning	mattino
painter	pittore
bobby	bobby
combination	combinazione
planet	pianeta
national	nazionale
nick	nick
suo	suo
billions	miliardi
cylinders	cilindri
july	luglio
series	serie
couple	coppia
error	errore
lp	lp
signals	segnali
clinton	clinton
enzo	enzo
competition	concorrenza
double	doppio
hp	hp
colleges	colleges
florence	firenze
minimum	minimo
connection	connessione
music	musica
lombard	lombardo
agencies	agenzie
ideas	idee
actor	attore
nevada	nevada
soldati	soldati
amm	amm
sectors	settori
all,	tutti
day	giornata
virus	virus
species	specie
ben	ben
process	processo
tree	albero
rabbi	rabbino
jeff	jeff
always	sempre
activity	attività
estimated	stimato
fascism	fascismo
respectively	rispettivamente
strong	forte
mental	mentale
kitchen	cucina
ve	ve
queensland	queensland
thu	thu
oklahoma	oklahoma
why	perchè
perfect	perfetto
questions	questions
cuba	cuba
terminated	terminato
someone	qualcuno
loss	perdita
violence	violenza
equilibrium	equilibrio
archdiocese	arcidiocesi
information	informazione
december	dicembre
areas	aree
orthodox	ortodosso
casualties	casualties
threat	minaccia
massa	massa
foreseen	previsto
detail	dettaglio
logic	logica
varese	varese
residents	residenti
categories	categorie
luciano	luciano
volumes	volumi
brazilian	brasiliano
finnish	finlandese
eu	eu
teresa	teresa
side	lato
fama	fama
façade	facciata
city	città
snow	neve
austriaca	austriaca
contains	contiene
can	can
walls	muri
mystery	mistero
den	den
stuart	stuart
power	potere
marble	marmo
humanity	umanità
disney	disney
quota	quota
ten	dieci
rfc	rfc
festival	festival
dakota	dakota
comprehensive	comprehensive
equivalent	equivalente
heraldry	araldica
french	francese
summit	sommità
terminus	terminus
relevance	rilevanza
alte	alte
guard	guardia
cats	gatti
rain	pioggia
mussolini	mussolini
islamic	islamico
alliance	alleanza
few	pochi
statue	statua
wrote	scrisse
segue	segue
overseas	overseas
specifications	specifiche
sua	sua
sola	sola
sul	sul
joint	giuntura
russa	russa
exposed	esposto
illinois	illinois
practices	pratiche
surgery	chirurgia
influential	influente
trama	trama
cell	cellula
freddo	freddo
commented	commentato
inspired	ispirato
fonda	fonda
capacity	capacità
publications	pubblicazioni
hungary	ungheria
full	pieno
microsoft	microsoft
this	questo
birmingham	birmingham
nuovi	nuovi
observations	osservazioni
money	denaro
cinematographic	cinematografico
celestial	celeste
idea	idea
trophy	trofeo
soldi	soldi
manner	maniera
architecture	architettura
considering	considerando
refuge	rifugio
grotto	grotta
reliable	affidabile
connecticut	connecticut
ancona	ancona
growth	crescita
member	membro
dna	dna
old	vecchio
medals	medaglie
improvements	miglioramenti
fuso	fuso
criterion	criterio
confrontation	confronto
iraq	iraq
paragraph	paragrafo
scientist	scienziato
clan	clan
renaissance	rinascimento
past	passato
colors	colori
opera	opera
hebrews	ebrei
served	servito
pronto	pronto
eggs	uova
swedish	svedese
png	png
ministers	ministri
informatics	informatica
caesar	cesare
you	tu
pact	patto
interviews	interviste
grown	cresciuto
fans	tifosi
stanza	stanza
three	tre
jan	jan
fear	paura
armata	armata
fascist	fascista
camillo	camillo
supporters	sostenitori
regime	regime
sicily	sicilia
philosopher	filosofo
lateral	laterale
masculine	maschile
harry	harry
farmers	agricoltori
diff	diff
assunta	assunta
five	cinque
base	base
recognitions	riconoscimenti
mini	mini
boy	ragazzo
nobility	nobiltà
diameter	diametro
sia	sia
patriarch	patriarca
louisiana	louisiana
practically	praticamente
key	chiave
collaboration	collaborazione
nucleus	nucleo
digital	digitale
corrado	corrado
groups	gruppi
attention	attenzione
editors	redattori
ultimo	ultimo
secrets	segreti
blocks	blocchi
fanno	fanno
mariano	mariano
hong	hong
argentina	argentina
franchi	franchi
simon	simone
constitutes	costituisce
seconds	secondi
vs	vs
marie	marie
notes	appunti
michael	michele
bomb	bomba
mask	maschera
revised	riveduta
chancellor	cancelliere
gulf	golfo
variable	variabile
bordo	bordo
governments	governments
explosion	esplosione
priest	sacerdote
hole	buco
eccentricity	eccentricità
adrian	adriano
delhi	delhi
district	distretto
electric	elettrico
infancy	infanzia
condemned	condannato
train	treno
lucas	lucas
annually	annualmente
siena	siena
vengeance	vendetta
obviously	ovviamente
consequences	conseguenze
months	mesi
international	internazionale
cupola	cupola
central	centrale
substantial	sostanziale
contributing	contribuendo
saskatchewan	saskatchewan
models	modelli
finalist	finalista
wiki	wiki
friuli	friuli
damaged	danneggiato
famous	famoso
europa	europa
monastery	monastero
new	nuovo
settlements	insediamenti
testi	testi
project	progetto
dramatic	drammatico
manifestation	manifestazione
adopted	adottato
artistic	artistico
or%	or%
bulgarian	bulgaro
libraries	biblioteche
industries	industrie
tournament	torneo
character	carattere
chapel	cappella
husband	marito
radio	radio
protagonist	protagonista
olympics	olimpiadi
austria	austria
habitat	habitat
pope	papa
mathematics	matematica
respect	rispetto
curve	curva
typical	tipico
singles	singoli
crew	equipaggio
honors	onori
girls	ragazze
modern	moderno
strictly	strettamente
london	londra
johnson	johnson
scholars	studiosi
founders	fondatori
canal	canale
attacking	attaccante
idaho	idaho
lee	lee
clock	orologio
harold	harold
euro	euro
places	luoghi
brussels	bruxelles
recently	recentemente
aaron	aaron
situations	situazioni
silvio	silvio
alpine	alpino
global	globale
partner	partner
automatic	automatico
sotto	sotto
gonzaga	gonzaga
researches	ricerche
observation	osservazione
virginia	virginia
expatriates	espatriati
zi	zi
treaty	trattato
bologna	bologna
des	des
table	tavolo
battles	battaglie
giro	giro
couples	coppie
images	immagini
competitions	concorsi
tribunal	tribunale
gamma	gamma
eva	eva
excellent	eccellente
bengal	bengala
prose	prosa
yale	yale
substitution	sostituzione
universe	universo
myth	mito
fifty	cinquanta
register	registro
ranking	ranking
em	em
felt	feltro
sockpuppets	sockpuppets
roger	roger
mouth	bocca
und	und
colonial	coloniale
transit	transito
conventional	convenzionale
hawaii	hawaii
traditions	tradizioni
sue	sue
da	da
runners	corridori
repeated	ripetuto
au	au
elisabetta	elisabetta
sites	siti
producer	produttore
misto	misto
concrete	concreto
demolished	demolito
engineer	ingegnere
surname	cognome
explorer	esploratore
blog	blog
errors	errori
archive	archivio
night	notte
we	noi
russi	russi
dialogue	dialogo
framework	framework
seventy	settanta
boston	boston
das	das
emergency	emergenza
oratorio	oratorio
training	addestramento
romagna	romagna
concession	concessione
independence	indipendenza
tower	torre
clinical	clinico
edward	edward
suggests	suggerisce
event	evento
beach	spiaggia
animated	animato
wounded	ferito
squad	squadra
retirement	pensionamento
schools	scuole
filmed	filmato
studies	studi
economy	economia
inhabitants	abitanti
lines	linee
giancarlo	giancarlo
exception	eccezione
magnitude	magnitudine
taught	insegnato
keep	keep
decoration	decorazione
treviso	treviso
genre	genere
eagle	aquila
woman	donna
club	club
platform	piattaforma
uncle	zio
components	componenti
visual	visuale
signs	segni
cotton	cotone
combat	combattimento
author	autore
context	contesto
bar	bar
considerable	considerevole
attempts	attempts
palermo	palermo
verses	versi
constant	costante
birth	nascita
sisters	sorelle
semifinals	semifinali
election	elezione
ian	ian
liberi	liberi
vice	vizio
presidential	presidenziale
markets	mercati
threatened	threatened
larry	larry
jazz	jazz
dated	datato
received	ricevuto
observed	osservato
chicago	chicago
flood	alluvione
strait	stretto
migliore	migliore
nello	nello
bay	baia
edinburgh	edimburgo
cgi	cgi
producers	produttori
giovanni	giovanni
content	contenuto
anglican	anglicano
leader	leader
excellence	eccellenza
passion	passione
commission	commissione
republican	repubblicano
bob	bob
factory	fabbrica
genres	generi
brigade	brigata
brunswick	brunswick
adventure	avventura
sanremo	sanremo
peninsula	penisola
atto	atto
gear	ingranaggio
documents	documenti
belgium	belgio
martial	marziale
squads	squadre
primary	primario
originals	originali
remix	remix
drawings	disegni
office	ufficio
ceremony	cerimonia
google	google
region	regione
instance	istanza
duo	duo
resident	residente
subjects	soggetti
representation	rappresentazione
secondary	secondario
dame	dama
graphic	grafico
pain	dolore
part	parte
positive	positivo
artist	artista
posteriori	posteriori
eight	otto
cardinal	cardinale
conditions	condizioni
qualified	qualificato
tongues	lingue
father	padre
soloist	solista
chronicle	cronaca
coasts	coste
police	polizia
tamil	tamil
miller	mugnaio
nicolas	nicolas
weapons	armi
society	società
shoulders	spalle
visible	visibile
moderns	moderni
napoleon	napoleone
critic	critico
firm	firm
lancia	lancia
closed	chiuso
revenue	reddito
sphere	sfera
edwards	edwards
literally	letteralmente
actress	attrice
suffered	sofferto
gentile	gentile
cardinals	cardinali
turk	turco
lazio	lazio
manhattan	manhattan
advanced	avanzato
monday	lunedì
egyptian	egiziano
politics	politica
exemplar	esemplare
youth	gioventù
visitor	visitatore
perse	perse
rhythm	ritmo
cells	cellule
hull	scafo
resa	resa
lati	lati
joseph	giuseppe
format	formato
vittorio	vittorio
portland	portland
popular	popolare
zero	zero
romanian	rumeno
rice	riso
hd	hd
valid	valido
inside	dentro
necessity	necessità
sovereigns	sovrani
separate	separato
medieval	medievale
withdrawn	ritirato
lewis	lewis
soli	soli
vedi	vedi
industrial	industriale
messages	messaggi
wave	onda
winners	vincitori
brazil	brazil
united	unito
readers	lettori
archaeological	archeologico
germans	tedeschi
jerry	jerry
completion	completamento
academic	accademico
median	mediana
asia	asia
clean	pulito
proof	prova
vicinities	vicinanze
hook	gancio
definitive	definitivo
knowledge	conoscenza
plant	pianta
debut	debutto
soap	sapone
breed	razza
feedback	feedback
adversaries	avversari
also	anche
correctly	correttamente
emperor	imperatore
ideal	ideale
inferior	inferiore
profoundly	profondamente
commitment	impegno
preparation	preparazione
figure	figura
ray	raggio
vessel	vascello
detailed	dettagliato
conti	conti
creation	creazione
finlandia	finlandia
expenses	spese
mountains	montagne
anton	anton
pdf	pdf
teachers	insegnanti
levels	livelli
virtual	virtuale
embassy	ambasciata
widow	vedova
disambiguation	disambiguazione
unica	unica
brisbane	brisbane
christians	cristiani
continuo	continuo
revealed	rivelato
initially	inizialmente
ottawa	ottawa
successively	successivamente
deaths	morti
anti	anti
image	immagine
raffaele	raffaele
leg	gamba
rare	raro
restricted	restricted
instruments	strumenti
robot	robot
painters	pittori
endemic	endemico
lisa	lisa
anchor	ancora
left	sinistra
library	biblioteca
standard	standard
