progress	прогресс
elite	элита
acid	кислота
production	производство
agent	агент
boats	лодки
existence	существование
dynasties	династии
period	период
musician	музыкант
won	выиграл
federations	федерации
extreme	экстремальный
bavaria	бавария
episode	эпизод
number	номер
moral	моральный
significance	significance
riverine	речной
ring	кольцо
uprisings	восстания
marketing	маркетинг
acids	кислоты
frederick	фредерик
tail	хвост
defender	защитник
green	зеленый
colleague	коллега
dnieper	днепр
egyptian	египетский
reign	царствование
dmitrievich	дмитриевич
rugby	регби
load	нагрузка
financial	финансовый
encyclopedias	энциклопедии
warning	предупреждение
lloyd	ллойд
lakes	озёра
navigation	навигация
maria	мария
quantum	квант
catherine	екатерина
horror	ужас
january	январь
fishing	рыбалка
violations	нарушения
architects	архитекторы
television	телевидение
laura	лаура
anglo	англо
probably	вероятно
tanks	танки
emperor	император
section	секция
milk	молоко
practically	практически
portal	портал
nasa	nasa
his	его
private	частный
organized	организованный
hungarian	венгерский
wings	крылья
serbian	сербский
energy	энергия
animal	животное
shield	щит
systems	системы
british	британский
malaysia	малайзия
case	падеж
giant	гигант
student	студент
locomotives	локомотивы
ivanovich	иванович
engine	двигатель
bear	медведь
unless	unless
fruit	плод
resource	ресурс
murray	murray
brazil	бразилия
sign	знак
apple	яблоко
infobox	инфобокс
generations	поколения
scottish	шотландский
rare	редкий
finnish	финский
leader	leader
inspired	вдохновлен
neutral	нейтральный
jackson	джексон
partial	частичный
producers	производители
large	large
these	эти
cat	кот
america	америка
less	меньше
words	слова
posthumously	посмертно
democrats	демократы
archives	архивы
blocks	блоки
courts	суды
purple	purple
hughes	hughes
cost	стоимость
side	сторона
madrid	мадрид
richmond	ричмонд
lions	львы
editors	редакторы
classical	классический
caribbean	карибский
all,	все
up	вверх
sea	море
junior	младший
harold	гарольд
bus	автобус
independently	независимо
ceo	ceo
active	активный
republic	республика
the	the
agents	агенты
appropriate	appropriate
threat	угроза
parker	паркер
norwegian	норвежский
academician	академик
competition	соревнование
arrangement	аранжировка
books	книги
carbon	углерод
arnold	арнольд
possibility	возможность
egypt	египет
chicago	чикаго
lieutenant	лейтенант
cincinnati	cincinnati
tag	тег
skills	навыки
afghanistan	афганистан
collins	коллинз
wind	ветер
empire	империя
hotel	гостиница
blue	синий
sweden	швеция
bed	постель
commentaries	комментарии
lon_dir	lon_dir
leonard	леонард
pupils	ученики
edward	эдвард
concerning	concerning
voivodeship	воеводство
specialized	специализированный
age	возраст
guitarist	гитарист
supporters	supporters
thailand	таиланд
bar	бар
editing	редактирование
properties	свойства
audio	аудио
drum	барабан
netherlands	нидерланды
dramatic	драматический
writer	писатель
makeup	макияж
tracks	tracks
representative	представитель
yugoslavia	югославия
english	английский
wide	широкий
horses	лошади
liberation	освобождение
newspaper	газета
multiple	множественный
camera	камера
master	мастер
big	большой
choir	хор
sponsored	спонсируется
austrian	австрийский
saskatchewan	саскачеван
opposite	противоположный
roles	роли
industry	промышленность
historians	историки
switzerland	швейцария
beautiful	beautiful
senate	сенат
miller	мельник
conference	конференция
speeches	речи
musicians	музыканты
runner	бегун
alabama	алабама
park	парк
professor	профессор
anywhere	anywhere
compositions	сочинения
bot	бот
rural	се́льский
cattle	скот
fly	муха
wine	вино
alice	алиса
continuing	продолжающийся
strange	странный
hidden	скрытый
music	музыка
ryan	ryan
barcelona	барселона
concerts	концерты
minsk	минск
statistical	статистический
june	июнь
templates	шаблоны
commercial	коммерческий
chairman	председатель
victory	победа
infantry	пехота
investigation	расследование
marriage	брак
speed	скорость
membership	членство
visit	визит
artificial	artificial
study	изучение
million	миллион
user	пользователь
arab	араб
old	старый
windows	окна
river	река
ships	корабли
aspect	аспект
september	сентябрь
brigade	бригада
maryland	мэриленд
automobile	автомобиль
combined	комбинированный
writes	пишет
voters	избиратели
aka	aka
permanently	постоянно
downtown	downtown
data	данные
clinical	клинический
white	белый
shores	берега
circumstances	обстоятельства
organs	органы
interior	интерьер
honorary	почетный
arguments	аргументы
april	апрель
effect	эффект
gothic	готический
grace	благодать
sun	солнце
sexual	сексуальный
closure	закрытие
marina	марина
upper	верхний
laureate	лауреат
critic	критик
conductor	дирижер
swimming	плавание
finds	находит
modified	модифицированный
conservative	консервативный
color	цвет
reader	читатель
radar	радар
context	контекст
house,	дом
articles	статьи
soul	душа
myself	myself
nation	нация
derby	дерби
portion	порция
hunting	охота
profession	профессия
rogers	роджерс
obvious	очевидный
greek	греческий
invasion	вторжение
october	октябрь
blood	кровь
priest	священник
february	февраль
components	компоненты
please	пожалуйста
adult	взрослый
income	доход
run	бег
interests	интересы
publishing	издательство
lisa	lisa
anatoly	анатолий
absence	отсутствие
alex	alex
worst	худший
relatively	относительно
blog	блог
conferences	конференции
specific	специфический
czech	чешский
mile	миля
editorial	редакционный
legitimate	легитимный
principality	княжество
bureau	бюро
eighth	восьмой
hockey	хоккей
energies	энергии
animation	анимация
biology	биология
anime	аниме
term	термин
director	директор
industrial	промышленный
professors	профессора
charles	чарльз
deal	сделка
leaf	лист
control	контроль
loneos	loneos
text	текст
column	колонка
milan	милан
ball	мяч
annually	ежегодно
organic	органический
double	двойной
princess	принцесса
socks	socks
such	такой
nebraska	небраска
moves	moves
alumni	alumni
architect	архитектор
geographies	географии
lat_dir	lat_dir
figure	фигура
form	форма
bank	банк
charter	хартия
sarah	sarah
ordered	заказанный
understanding	понимание
christians	христиане
africa	африка
program	программа
driving	вождение
answers	ответы
bonus	бонус
apartment	квартира
fighters	бойцы
weather	погода
cats	кошки
published	опубликованный
medicine	медицина
lesser	меньший
chapel	капелла
firm	фирма
journalist	журналист
factually	фактически
switch	переключатель
protein	белок
behavior	поведение
reservoir	резервуар
york	йорк
heat	жара
files	файлы
fortepiano	фортепиано
competitive	соревновательный
son	сын
fast	быстрый
socialist	социалист
libraries	библиотеки
effectively	эффективно
readers	читатели
elizabeth	елизавета
bass	бас
during	during
clay	глина
baltimore	балтимор
seed	семя
victoria	виктория
queens	королевы
spot	пятно
model	модель
singapore	сингапур
vertical	вертикальный
hitler	гитлер
army	армия
speech	речь
back	назад
higher	высший
atlanta	атланта
persian	персидский
values	ценности
stars	звезды
campaign	кампания
expert	эксперт
brunswick	brunswick
star	звезда
educational	образовательный
connecticut	коннектикут
chemistry	химия
reserve	резерв
oxford	оксфорд
new	новый
criticism	критика
operas	оперы
underground	underground
louis	louis
we	мы
report	отчет
gold	золото
black	чёрный
improvement	улучшение
physicists	физики
iowa	айова
official	официальный
legs	ноги
planets	планеты
methods	методы
resources	ресурсы
laureates	лауреаты
childhood	детство
adam	адам
indonesia	индонезия
word	слово
audience	аудитория
guard	охранник
cooperation	сотрудничество
euro	евро
achievements	достижения
semyonovich	семёнович
clearer	яснее
oakland	окленд
academic	академический
month	месяц
cable	кабель
patients	пациенты
festival	фестиваль
volunteer	доброволец
super	super
approximately	приблизительно
cleveland	кливленд
decade	десятилетие
artistic	artistic
jerusalem	иерусалим
loss	потеря
simon	симон
blocked	заблокирован
evil	зло
estate	estate
plant	растение
hand	рука
officers	офицеры
voices	голоса
significant	significant
november	ноябрь
rear	задняя
appeal	апелляция
cousin	кузен
gallery	галерея
patrick	патрик
plan	план
retired	retired
chair	кресло
interaction	interaction
gates	ворота
schedule	расписание
conducted	conducted
motor	мотор
excellent	excellent
coal	уголь
facebook	facebook
include	вкл
achievement	достижение
sharply	резко
committee	комитет
gary	gary
reminiscences	воспоминания
expression	выражение
closed	закрытый
org/wiki/	org/wiki/
kilometers	километров
digital	цифровой
programs	программы
seventh	седьмой
fantasy	фантазия
google	google
scene	сцена
greece	греция
governors	губернаторы
arrest	арест
colors	цвета
edwards	эдвардс
useful	полезный
hat	шляпа
method	метод
rail	рельс
born	рожденный
john	джон
acts	акты
activists	активисты
diego	диего
walter	валтер
automatic	автоматический
ratio	соотношение
component	компонент
seal	печать
michael	михаил
psychology	психология
reaction	реакция
unique	уникальный
belgium	бельгия
flag	флаг
medalists	медалисты
publishers	издатели
rank	rank
career	карьера
beauty	красота
brick	кирпич
primary	первичный
champions	чемпионы
kiev	киев
finland	финляндия
animals	животные
garden	сад
controversy	controversy
temple	храм
strong	сильный
serious	серьезный
illegal	нелегальный
usa	usa
perspective	перспектива
flower	цветок
cave	пещера
schools	школы
contains	содержит
road	дорога
awards	награды
biological	биологический
photograph	фотография
craig	craig
jump	прыжок
criterion	критерий
season	сезон
karl	karl
temporarily	временно
expeditions	экспедиции
struck	struck
fuel	топливо
skin	кожа
shore	берег
virus	вирус
days	дни
responsibility	ответственность
sector	сектор
tommy	томми
secondary	вторичный
examples	examples
lists	списки
retrieved	retrieved
lines	линии
democracy	демократия
albert	альберт
victim	жертва
its	its
colleagues	коллеги
regime	режим
glass	стекло
fifth	пятый
croatia	хорватия
poland	польша
belgian	бельгийский
parish	приход
openly	открыто
artist	художник
dragon	дракон
experimental	экспериментальный
squadron	эскадра
crisis	кризис
constitutions	конституции
episodes	эпизоды
daniel	даниэль
delivery	доставка
mountains	горы
crystals	кристаллы
exclusive	эксклюзивный
pearl	жемчуг
individual	индивиду
judges	судьи
destruction	разрушение
commonwealth	commonwealth
off	off
spring	весна
show	шоу
august	август
training	обучение
administration	администрация
normal	нормальный
panel	панель
player	игрок
colleges	колледжи
eric	эрик
promotion	продвижение
plans	планы
fifty	пятьдесят
weapon	оружие
stadium	стадион
kings	короли
illinois	иллинойс
ocean	океан
tank	танк
mars	марс
clerk	клерк
nelson	нельсон
triple	тройной
wooden	деревянный
he	он
article	статья
victorian	викторианский
ship	корабль
framework	фреймворк
duke	герцог
chancellor	канцлер
rule	правило
florida	florida
winter	зима
tourism	туризм
leningrad	ленинград
possible	возможный
them	them
faith	вера
athletic	атлетический
japanese	японский
registered	зарегистрирован
body	тело
brazilian	бразильский
susan	susan
vegas	вегас
armenian	армянин
cambridge	кембридж
levels	levels
jesus	иисус
trials	trials
brigades	бригады
offensive	наступательный
processes	процессы
donald	дональд
masculine	мужской
murder	убийство
tropical	тропический
themes	темы
vermont	вермонт
celtic	кельтский
lincoln	линкольн
mario	марио
canadian	канадский
soon	скоро
cosmos	космос
administrative	административный
archbishop	архиепископ
characteristics	характеристики
politics	политика
utah	utah
way,	путь
theory	теория
adventures	приключения
kingdom	королевство
principle	принцип
anderson	андерсон
opera	опера
equal	равный
proof	доказательство
robot	робот
standards	стандарты
doubt	сомнение
style	стиль
candidates	кандидаты
divided	разделенный
dakota	дакота
crowd	толпа
patrol	патруль
separately	отдельно
buddhist	буддийский
liberal	либеральный
cultural	культурный
captain	капитан
oliver	оливер
coordinates	координаты
search	поиск
idea	идея
communes	коммуны
say	say
theories	теории
leaves	листья
refusal	отказ
virtual	виртуальный
enemy	враг
scenes	сцены
corporation	корпорация
campus	кампус
germany	германия
sources	источники
theme	тема
volleyball	волейбол
record	рекорд
outstanding	выдающийся
scholarship	стипендия
frequency	частота
missouri	миссури
immigrants	иммигранты
actors	актеры
reactions	реакции
internet	интернет
ffffff	ffffff
disk	диск
evaluations	оценки
harris	harris
tons	тонны
hope	надежда
families	семьи
queensland	квинсленд
wisconsin	висконсин
gregory	григорий
guidance	руководство
adventure	приключение
pretensions	претензии
identifier	идентификатор
formal	формальный
negotiations	переговоры
scott	скотт
nature	природа
century	век
press	пресса
producer	производитель
dead	мёртвый
battle	битва
dating	dating
wilhelm	вильгельм
president	президент
azerbaijan	азербайджан
science	наука
singer	певец
guilty	виновен
critical	критический
india	индия
majority	большинство
commander	командир
pictures	картинки
george	георгий
variable	переменная
real	реальный
yakovlevich	яковлевич
uniform	униформа
rebellion	бунт
agricultural	agricultural
ordinary	обычный
imperial	имперский
opponents	оппоненты
policies	policies
encyclopedia	enciklopedija
negative	отрицательный
belarus	беларусь
amateur	любитель
authors	авторы
israeli	израильский
crystal	кристалл
integrated	интегрированный
direction	направление
fresh	свежий
royal	королевский
paul	павел
hero	герой
tsar	царь
analysis	анализ
papa	папа
distribution	распределение
marks	marks
agreement	соглашение
grant	грант
professional	профессиональный
orthodox	православный
lawrence	лоуренс
seconds	секунды
sister	сестра
portland	портленд
rose	роза
ghost	призрак
patient	пациент
literature	литература
wikipedians	википедисты
library	библиотека
task	задача
francisco	франциско
address	адрес
orange	апельсин
logic	логика
factor	фактор
low	низкий
spain	испания
nazi	нацист
london	лондон
bronze	бронза
metric	метрический
gas	газ
social	социальный
twenty	двадцать
notable	заметный
eight	восемь
elementary	элементарный
latest	latest
uprising	восстание
sections	секции
collected	collected
adjacent	adjacent
berkeley	беркли
lat_min	lat_min
interesting	интересный
kenya	kenya
tea	чай
angel	ангел
manchester	манчестер
challenge	вызов
face	лицо
alcohol	алкоголь
fundamental	фундаментальный
federation	федерация
drama	драма
process	процесс
anyone	anyone
ukrainian	украинский
soldier	солдат
plus	плюс
however	however
warren	warren
characteristic	характеристика
july	июль
importance	важность
network	сеть
external	внешний
necessity	необходимость
violation	нарушение
representation	представление
montana	монтана
twin	близнец
door	дверь
members	члены
reasonable	разумный
baker	пекарь
file	файл
bristol	бристоль
document	документ
very	очень
diamond	бриллиант
vienna	vienna
guberniya	губерния
wounded	раненый
empty	пустой
anonymous	анонимный
arthur	артур
lost	потерянный
jimmy	jimmy
virginia	вирджиния
opinion	мнение
johnny	джонни
surface	поверхность
punk	панк
seats	сиденья
birmingham	бирмингем
ottawa	оттава
bomb	бомба
designer	дизайнер
successful	успешный
matthew	матфей
franklin	франклин
valid	валидный
normally	нормально
flat	flat
role	роль
driver	водитель
central	центральный
poster	плакат
percent	процент
scenario	сценарий
patent	патент
types	типы
cavalry	кавалерия
height	высота
technique	техника
eagle	орёл
arrival	прибытие
continental	континентальный
alexey	алексей
syria	сирия
passengers	пассажиры
officially	официально
publicly	публично
orchestra	оркестр
oklahoma	оклахома
konstantinovich	константинович
should	должен
interview	интервью
wild	дикий
steel	сталь
light	свет
serbia	сербия
queen	королева
what	что
why	почему
developing	развивающаяся
depth	глубина
domain	домен
joan	жоан
ceremony	церемония
mediterranean	mediterranean
resistance	сопротивление
reputation	репутация
atlantic	атлантический
noble	благородный
automatically	автоматически
solo	solo
religion	религия
accusations	обвинения
owner	владелец
signature	подпись
defeat	поражение
warriors	воины
spam	спам
this	это
comedy	комедия
latin	латинский
palace	дворец
obviously	очевидно
albums	альбомы
poor	бедный
physico	физико
comics	комиксы
landing	посадка
lebanon	ливан
wikipedia	википедия
census	перепись
equivalent	эквивалент
manhattan	manhattan
religious	религиозный
complexities	сложности
coastal	прибрежный
without	без
anton	антон
concretely	конкретно
incidents	инциденты
sugar	сахар
traditional	традиционный
war	война
participant	участник
dam	плотина
abu	abu
indiana	индиана
office	офис
norfolk	норфолк
hollywood	голливуд
thank	спасибо
fleet	флот
dean	декан
four	четыре
appointed	назначенный
maximum	максимум
genres	жанры
simple	простой
institute	институт
revolution	революция
bachelor	bachelor
participation	участие
barbara	барбара
presidents	президенты
grigoryevich	григорьевич
products	продукты
palestine	палестина
competitions	соревнования
ian	ian
sweet	сладкое
editions	издания
delta	дельта
when	когда
employment	трудоустройство
education,	образование
purchase	покупка
regularly	регулярно
microsoft	майкрософт
obama	обама
oldest	старейший
chain	цепь
jersey	jersey
temperature	temperature
nigeria	нигерия
design	дизайн
flora	флора
religions	религии
supreme	верховный
cultures	культуры
information	информация
mirror	зеркало
conflict	конфликт
comparison	сравнение
translator	переводчик
boy	мальчик
chiefly	главным
#efefef	#efefef
partners	партнеры
embassy	посольство
bush	буш
weak	слабый
minnesota	миннесота
rfc	rfc
jerry	jerry
saved	спасен
chile	chile
exposure	exposure
kazakhstan	казахстан
pennsylvania	пенсильвания
wedding	свадьба
eparchy	епархия
market	рынок
joe	joe
knyaz	князь
universe	вселенная
amazon	амазонка
personalities	личности
metro	метро
hunter	охотник
label	этикетка
principles	принципы
pages	страницы
even	even
russian	русский
ivan	иван
douglas	дуглас
islam	ислам
points	точки
ancient	древняя
too	слишком
food	еда
bridge	мост
infrastructure	инфраструктура
disney	дисней
launch	запуск
liverpool	ливерпуль
rulers	правители
specially	специально
fixed	фиксированный
maurice	морис
germans	немцы
brown	коричневый
valentine	валентин
kirill	кирилл
communist	коммунист
critics	критики
antonio	антонио
toronto	торонто
golf	гольф
so	so
immigration	иммиграция
berlin	берлин
josé	josé
portuguese	португальский
voting	голосование
forty	сорок
improved	улучшенный
newspapers	газеты
fish	рыба
clear	ясный
activist	активист
croatian	хорватский
herbert	герберт
devil	дьявол
jurisdiction	юрисдикция
military	военный
appointment	назначение
adults	взрослые
someone	someone
europe	европа
copy	копия
everything	everything
judge	судья
kentucky	кентукки
sixth	шестой
poets	poets
causes	причины
dependent	зависимый
session	сессия
village	деревня
movements	движения
destroyed	уничтоженный
dallas	даллас
if	если
down	вниз
variations	вариации
pedro	педро
candidate	кандидат
victims	жертвы
moon	луна
safe	безопасный
moment	момент
cover	обложка
train	поезд
entertainment	развлечение
life	жизнь
impression	впечатление
protocol	протокол
certified	сертифицированный
byzantine	византийский
meters	метры
stanley	стенли
church	церковь
residents	residents
posts	посты
presidential	президентский
and/or	и/или
combination	сочетание
raymond	раймонд
ceremonies	церемонии
hello	привет
corner	угол
loop	петля
fact	факт
aaron	аарон
alexandrovna	александровна
periods	периоды
concrete	бетон
how	как
charlie	чарли
inappropriate	неподходящий
evolution	эволюция
users	пользователи
thirty	тридцать
endemic	эндемичный
bashkortostan	башкортостан
specialist	специалист
type	тип
much	much
crew	экипаж
sheffield	sheffield
vancouver	ванкувер
suicide	самоубийство
operation	операция
sum	сумма
incident	инцидент
scientist	ученый
england	англия
spectacle	спектакль
they	они
happy	счастливый
theatrical	театральный
water	вода
scale	масштаб
line	линия
bird	птица
exit	выход
where	где
singing	пение
hudson	hudson
gilbert	гилберт
discussion	обсуждение
totally	totally
editor	редактор
experts	эксперты
health	здоровье
tournament	турнир
resolution	резолюция
technical	технический
diplomatic	дипломатический
scotland	шотландия
uncle	дядя
colonies	колонии
autonomous	автономный
dynamo	динамо
head	голова
bit	бит
hurricane	ураган
third	третий
several	several
massive	массивный
licensed	лицензирован
professions	профессии
rabbi	раввин
administrator	администратор
literally	буквально
dog	собака
nkvd	нквд
nearly	nearly
correct	правильный
bone	кость
identification	идентификация
preliminary	предварительный
cardinals	кардиналы
partnership	партнерство
arena	арена
sand	песок
signs	знаки
nicholas	николай
letter	буква
drummer	барабанщик
texas	техас
level	уровень
correctly	правильно
difficult	трудный
hamilton	хамильтон
saints	святые
reserves	резервы
jewish	еврейский
their	их
washington	вашингтон
branch	ветвь
literary	литературный
commission	комиссия
games	игры
teachers	преподаватели
cargo	груз
clubs	клубы
criteria	критерии
argentina	аргентина
hosted	hosted
rolling	rolling
syndrome	синдром
sport	спорт
saturday	суббота
baptist	baptist
front	фронт
francis	франциск
alan	alan
approved	одобренный
revolutions	революции
scheme	схема
important	важный
charge	заряд
sort	сорт
formally	формально
fighter	боец
montreal	монреаль
more	больше
grave	могила
platform	платформа
portrait	портрет
documents	документы
nepal	непал
municipal	municipal
step	шаг
fans	фаны
analogously	аналогично
soap	мыло
boris	борис
trade	торговля
december	декабрь
theatre	театр
congress	конгресс
bulgarian	болгарский
engineers	инженеры
philosopher	философ
bell	колокол
mathematicians	математики
credits	кредиты
ballet	балет
tax	налог
lake	озеро
sony	sony
sphere	сфера
kazan	казань
copper	медь
fox	лис
months	месяцы
quarter	четверть
tree	древо
minister	министр
sides	стороны
victor	победитель
asking	asking
indian	индийский
monthly	monthly
journey	путешествие
reality	реальность
israel	израиль
indigenous	indigenous
florence	флоренция
materials	материалы
bosnia	босния
stanislav	станислав
glance	взгляд
worse	хуже
mention	упоминание
planning	планирование
signal	сигнал
absolutely	абсолютно
prose	проза
although	although
guitar	гитара
jan	jan
strike	забастовка
protected	защищенный
international	международный
server	сервер
budget	бюджет
practical	практический
para	пара
nevada	невада
cricket	крикет
insects	насекомые
basketball	баскетбол
instrumental	инструментальный
reliable	надежный
bowling	боулинг
madison	мадисон
forward	вперед
depends	зависит
logotype	логотип
abilities	способности
brian	брайан
index	индекс
palestinian	палестинский
moscow	москва
senator	сенатор
brisbane	brisbane
tigers	tigers
composers	композиторы
trainers	тренеры
fred	фред
boston	бостон
radio	радио
robert	роберт
local	локальный
eagles	орлы
lon_min	lon_min
nearby	поблизости
dreams	сновидения
kingdoms	королевства
milwaukee	милуоки
neighborhood	neighborhood
almost	almost
allies	союзники
potentially	потенциально
interest	интерес
segment	сегмент
blind	слепой
investment	инвестирование
services	услуги
remnants	остатки
better	лучше
structure	структура
engineering	инженерное
architectures	архитектуры
battles	битвы
admiral	адмирал
lon_deg	lon_deg
manga	манга
redirect	перенаправление
philosophy	философия
corporate	корпоративный
mayor	мэр
demand	требование
partially	частично
legend	легенда
journals	журналы
centers	центры
moderately	умеренно
oregon	орегон
gross	гросс
%be%d	%be%d
business	бизнес
creative	креативный
lectures	лекции
winners	победители
laws	законы
rgb	rgb
morning	утро
father	отец
asian	азиатский
salt	соль
king	король
gennadiy	геннадий
bible	библия
sword	меч
finally	наконец
asia	азия
flight	полёт
played	играл
insee	insee
christianity	христианство
romance	romans
shift	сдвиг
robinson	робинзон
country,	страна
reception	прием
writers	писатели
harbor	гавань
permanent	постоянный
team,	команда
italian	итальянский
detroit	детройт
universities	университеты
agencies	агентства
community	община
monster	чудовище
academies	академии
approval	одобрение
dimitri	дмитрий
dramaturg	драматург
match	матч
online	онлайн
michigan	мичиган
leg	нога
longer	длиннее
minority	меньшинство
girls	девочки
colonial	колониальный
standard	стандарт
operator	оператор
worker	работник
zone	зона
managers	менеджеры
minute	минута
parallel	параллельный
somewhere	somewhere
supply	снабжение
ukraine	украина
day	день
citizenship	гражданство
suspended	suspended
department	отдел
eugenia	евгения
translation	перевод
freedom	svoboda
united	united
romanian	румынский
monitoring	мониторинг
swedish	шведский
song	песня
colombia	колумбия
contrast	контраст
diseases	болезни
spider	паук
contact	контакт
ч	ч
iso	iso
centuries	столетия
friendly	дружелюбный
andrey	андрей
attention	внимание
architecture	архитектура
campaigns	кампании
lgbt	лгбт
tasks	задачи
parliamentary	парламентский
shanghai	шанхай
danish	датский
philip	филипп
bulgaria	болгария
swiss	швейцарский
league	лига
eyes	глаза
republican	республиканец
indians	индейцы
laboratory	лаборатория
instrument	инструмент
abbey	аббатство
territorial	территориальный
encyclopedic	encyclopedic
choice	выбор
sunday	воскресенье
crimes	преступления
consumer	потребитель
towers	башни
hour	час
archaeological	археологический
operations	операции
davis	дэвис
alfred	альфред
yakov	яков
popularity	популярность
teacher	учитель
friend	друг
monuments	памятники
electricity	электричество
affect	аффект
limited	ограниченный
focus	фокус
efforts	усилия
peculiarities	особенности
slightly	слегка
fm	fm
canal	канал
colony	колония
sale	продажа
flowers	цветы
you	ты
inscription	надпись
contemporary	современный
hampshire	гэмпшир
boss	босс
band	бэнд
alive	живой
somerset	сомерсет
pavlovich	павлович
progressive	прогрессивный
iranian	иранский
website	вебсайт
situations	ситуации
crater	кратер
state	государство
houston	хьюстон
coat	пальто
lp	lp
politician	политик
owners	владельцы
glasgow	глазго
rhythm	ритм
template	шаблон
projects	проекты
guitars	гитары
hong	hong
losses	убытки
place	место
slave	раб
perhaps	perhaps
melbourne	мельбурн
texts	тексты
rifle	винтовка
inside	внутри
american	американец
march	марш
actor	актер
olga	ольга
ioanna	иоанна
aspects	аспекты
seven	семь
forum	форум
essay	эссе
midfielder	полузащитник
lawyer	адвокат
long	длинный
kansas	канзас
affiliated	аффилирован
debut	дебют
further	дальше
publisher	издатель
money	деньги
events	события
missing	пропавший
requests	запросы
air	воздух
sufficient	достаточный
journalism	журналистика
homestead	хутор
question	вопрос
ottoman	ottoman
roger	роджер
things	вещи
culture	культура
performers	исполнители
alexander	александр
girl	девочка
muslims	мусульмане
chemical	химический
pakistani	пакистанский
forest	лес
reed	камыш
window	окно
reds	красные
anna	анна
protections	защиты
silver	серебро
battalion	батальон
locations	locations
cup	чашка
museum	музей
destiny	судьба
farm	ферма
villages	деревни
socorro	сокорро
street	улица
influence	влияние
asp	асп
gospel	евангелие
greatest	greatest
dynasty	династия
welsh	валлийский
gif	gif
frank	франк
jefferson	джефферсон
pat	пат
procedure	процедура
concert	концерт
armed	вооруженный
iraq	iraq
daughter	дочь
tennis	теннис
woman	женщина
bobby	bobby
athens	афины
heavy	тяжелый
relating	относящийся
democratic	демократический
adaptation	адаптация
bbc	bbc
planet	планета
stone	камень
monday	понедельник
turn	поворот
oblast	oblast
ninth	девятый
respected	уважаемый
terminal	терминал
graphics	графика
foundation	фундамент
variant	вариант
fair	ярмарка
expedition	экспедиция
successfully	успешно
stepanovich	степанович
museums	музеи
johnson	джонсон
churches	церкви
comprehensive	comprehensive
sound	звук
flash	флэш
regular	регулярный
tamil	тамильский
world,	мир
baron	барон
album	альбом
brother	брат
miami	майами
doubts	сомнения
christian	христианин
paid	paid
symbol	символ
performance	выступление
material	материал
composition	сочинение
shah	shah
group	группа
screenwriter	сценарист
seriously	серьезно
point	точка
wars	войны
legislative	законодательный
jacques	jacques
two	dva
heart	сердце
guest	гость
advertisement	реклама
eastern	восточный
week	неделя
western	западный
key	ключ
satellite	спутник
paris	париж
arkansas	арканзас
engineer	инженер
dates	даты
length	длина
night	ночь
made	сделанный
deck	палуба
dictionary	словарь
cycle	цикл
six	шесть
ontario	онтарио
arabic	арабский
wellington	веллингтон
oleg	олег
click	click
popular	популярный
husband	супруг
theology	богословие
experience	опыт
roberta	роберта
telephone	телефон
patterns	паттерны
cause	причина
always	всегда
african	африканский
mobile	мобильный
tower	башня
academy	академия
ten	десять
immediate	immediate
counter	контр
genre	жанр
administrators	администраторы
soviet	совет
konstantin	константин
carolina	каролина
interwikis	интервики
cathedral	собор
bowl	боул
population	население
peter	петр
trained	обученный
favorite	любимый
blues	блюз
red	красный
fedorovich	фёдорович
news	новости
airport	аэропорт
enthalpy	энтальпия
safety	безопасность
masses	массы
class	класс
eleven	одиннадцать
quebec	квебек
williams	вильямс
definitely	определенно
bridges	мосты
citations	цитаты
communications	коммуникации
korea	корея
programming	программирование
occupied	оккупированный
manor	manor
shot	выстрел
protest	протест
involvement	вовлечение
seasons	сезоны
phrase	фраза
republics	республики
austria	австрия
shadow	тень
insurance	страхование
script	скрипт
carrier	носитель
collectives	коллективы
preceding	предшествующий
planned	запланированный
acceptable	приемлемый
phrases	фразы
html	html
establishments	учреждения
rd	rd
electronic	электронный
typical	типичный
round	круглый
medical	медицинский
wave	волна
clinton	клинтон
genetic	генетический
territory	territory
belarusian	белорусский
angels	ангелы
australia	австралия
corps	корпус
cross	крест
frame	рамка
mountain	гора
minutes	минуты
wall	стена
machine	машина
denver	денвер
law	закон
bishop	епископ
drivers	водители
mog	мог
work	работа
singers	певцы
beginning	начало
seminaries	семинарии
canada	канада
sultan	султан
camp	лагерь
citizen	гражданин
mythology	мифология
departure	отъезд
future	будущее
finals	финалы
belt	пояс
twice	дважды
overseas	зарубежный
fire	огонь
joseph	иосиф
leonid	леонид
computer	компьютер
unsuccessful	неудачный
benjamin	бенджамин
proposal	предложение
ivanov	иванов
students	студенты
daughters	дочери
ours	наш
hall	зал
center	центр
california	калифорния
complex	комплекс
drums	барабаны
spanish	испанский
mathematics	математика
inhabitants	жители
broadcasting	broadcasting
happened	случилось
widespread	распространенный
tiger	tiger
thomas	томас
larry	larry
year	год
mexican	мексиканский
meat	мясо
valley	долина
khan	хан
discovery	открытие
brothers	братья
snow	снег
holland	голландия
attempts	попытки
secretary	секретарь
reforms	реформы
activity	деятельность
married	замужем
tatiana	татьяна
clean	чистый
original	оригинальный
violence	насилие
crime	преступление
treatment	лечение
athletes	спортсмены
jews	евреи
universal	универсальный
landscape	ландшафт
details	подробности
surgery	хирургия
regional	региональный
enterprises	предприятия
hole	дыра
turkish	турецкий
grandfather	дедушка
clan	клан
roads	дороги
david	давид
error	ошибка
heritage	наследие
differences	различия
romania	румыния
rights	права
tables	столы
disease	болезнь
actress	актриса
women	женщины
southern	южный
family	семья
art	искусство
calendar	календарь
wider	шире
french	француз
municipalities	муниципальные
strategic	стратегический
alaska	аляска
formula	формула
support	поддержка
americas	америки
peoples	народы
hearts	сердца
flood	потоп
anglican	англикан
taiwan	тайвань
thin	тонкий
content	содержание
competitors	конкуренты
masters	мастера
school	школа
pittsburgh	питтсбург
true	истинный
edition	издание
copies	копии
lady	дама
dangerous	опасный
bull	bull
dissemination	распространение
economically	экономически
additions	добавления
waters	воды
electrical	электрический
songs	песни
ensemble	ансамбль
project	проект
mill	мельница
subjects	субъекты
your	ваш
hospital	госпиталь
restoration	восстановление
baku	баку
tie	галстук
credit	кредит
unit	единица
languages	языки
participants	участники
initiative	инициатива
idaho	idaho
pattern	паттерн
request	запрос
remix	ремикс
version	версия
far	далеко
sold	проданный
memory	память
dramas	драмы
%bd%d	%bd%d
nothing	ничто
amsterdam	амстердам
award	награда
medals	медали
ice	лёд
engines	двигатели
talent	талант
arbitration	арбитраж
brand	бренд
steven	стивен
possibilities	возможности
navigational	навигационный
presence	присутствие
exhibition	выставка
child	ребенок
pilot	пилот
watson	ватсон
coffee	кофе
south	юг
statistics	статистика
sons	сыновья
waves	волны
kevin	kevin
agency	агентство
composer	композитор
markets	рынки
saudi	saudi
parent	родитель
natalya	наталья
tournaments	турниры
field	поле
sydney	сидней
management	управление
biographies	биографии
children	дети
arizona	аризона
siege	осада
volunteers	добровольцы
responsible	ответственный
status	статус
fan	фан
newton	ньютон
localities	местности
philadelphia	филадельфия
post	пост
issues	issues
open	открытый
qualified	квалифицированный
measures	меры
linear	линейный
evans	эванс
entrance	въезд
sacred	священный
small	маленький
championship	чемпионат
birds	птицы
wiki	вики
circle	круг
lat_sec	lat_sec
oscar	оскар
olympic	олимпийский
parameters	параметры
strategy	стратегия
football	футбол
noise	шум
graphic	графический
paper	бумага
existing	существующий
exercise	упражнение
nfl	нфл
never	никогда
north	север
map	карта
identity	идентичность
seattle	сиэтл
element	элемент
diesel	дизель
jordan	jordan
therapy	терапия
table	стол
parents	родители
young	молодой
ohio	огайо
spiritual	духовный
criminal	преступник
vincent	винсент
partner	партнер
offering	приношение
yorkshire	йоркшир
medal	медаль
technology	технология
genera	genera
knew	знал
globe	глобус
eugene	евгений
commune	коммуна
barry	барри
width	ширина
degree	степень
union	союз
raw	raw
governmental	государственное
mills	мельницы
visible	видимый
plate	тарелка
cards	карты
fifa	fifa
square	квадрат
horse	лошадь
shop	магазин
discoveries	открытия
short	короткий
palm	palma
dvd	dvd
temporary	временный
turkey	turkey
effects	эффекты
companies	компании
special	специальный
doctor	врач
harvard	гарвард
experiences	experiences
lie	ложь
video	видео
vandalism	вандализм
radical	радикальный
parliament	парламент
saint	святой
college	колледж
scholars	ученые
fifteen	пятнадцать
cold	холодный
pioneer	пионер
book	книга
ministers	министры
category	категория
around	вокруг
it	it
inch	дюйм
formulas	формулы
classification	классификация
delaware	делавэр
visibly	видимо
global	глобальный
acoustic	акустический
streets	улицы
australian	австралийский
thousand	тысяча
aviation	авиация
deep	глубокий
tunnel	туннель
predecessor	предшественник
controlled	контролируемый
acquired	приобретенный
positions	positions
catholic	католический
stanford	станфорд
philippines	филиппины
sooner	скорее
economy	экономика
qualities	качества
ray	ray
scientific	научный
advantage	преимущество
pressure	pressure
questions	вопросы
highway	шоссе
advanced	продвинутый
louisiana	луизиана
respect	уважение
ideal	идеальный
poverty	бедность
citizens	граждане
reading	чтение
sky	небо
footballers	футболисты
earthquake	землетрясение
civil	гражданский
nominator	номинатор
photographs	фотографии
santa	санта
opposition	оппозиция
regions	регионы
hospitals	госпитали
powerful	мощный
don	дон
adelaide	аделаида
nuclear	ядерный
congo	конго
franco	франко
room	комната
documentary	документальный
author	автор
capital	капитал
us	нас
shooting	стрельба
pirates	пираты
mission	миссия
researchers	исследователи
lion	лев
cells	клетки
object	предмет
product	продукт
independent	независимый
elevation	elevation
wheel	колесо
journalists	журналисты
james	джеймс
medieval	средневековый
diameter	диаметр
studio	студия
nine	девять
quality	качество
graduates	выпускники
accused	обвиняемый
tags	теги
htm	htm
foreign	иностранный
outside	снаружи
grass	трава
christmas	рождество
five	пять
asked	asked
plants	растения
generation	поколение
poem	стихотворение
minimum	минимум
danny	дэнни
leaders	leaders
company	компания
rules	правила
islamic	исламский
chess	шахматы
ready	готов
beer	пиво
she	она
late	поздно
bangladesh	бангладеш
weight	вес
monastery	монастырь
profit	прибыль
essex	эссекс
correspondingly	соответственно
graduate	выпускник
god	бог
brain	мозг
jazz	джаз
problem	проблема
sharp	острый
european	европейский
tributaries	притоки
tribe	племя
france	франция
suitable	подходящий
density	плотность
space	пространство
alternative	альтернативный
wales	уэльс
historical	исторический
dry	сухой
heroes	герои
martin	martin
desert	пустыня
locally	локально
senior	senior
attacks	атаки
name	имя
concern	concern
friends	друзья
trophy	трофей
russia	россия
summit	вершина
japan	япония
survey	опрос
bernard	бернард
chance	шанс
wallace	wallace
function	функция
distance	расстояние
volost	волость
valuable	ценный
contributions	contributions
anniversary	годовщина
indices	индексы
recommended	рекомендован
wrote	писал
unexpectedly	неожиданно
cgi	cgi
workers	рабочие
computers	компьютеры
sometimes	иногда
situation	ситуация
fortress	крепость
elements	элементы
defensive	оборонительный
profile	профиль
independence	независимость
chan	chan
dj	диджей
lat_deg	lat_deg
university	университет
climate	климат
movement	движение
guardian	опекун
cases	падежи
interface	интерфейс
effective	эффективный
mitchell	митчелл
walls	стены
symphony	симфония
twelve	двенадцать
crown	корона
richard	ричард
colonel	полковник
islands	острова
authority	авторитет
hook	крючок
stations	станции
jul	jul
saxony	саксония
manager	менеджер
nomination	номинация
sergei	сергей
perfect	perfect
ranking	ranking
personality	личность
pointed	остроконечный
naturally	естественно
page	страница
mental	mental
instruments	инструменты
dublin	дублин
metal	металл
course	курс
nominated	номинированный
wilson	вильсон
balance	баланс
brooklyn	бруклин
serial	серийный
prison	тюрьма
venezuela	венесуэла
officer	офицер
exchange	обмен
experiment	эксперимент
introduction	введение
dark	тёмный
performances	выступления
passenger	пассажир
island	остров
factors	факторы
influential	влиятельный
tempo	темп
continuation	продолжение
comic	комик
hawaii	гавайи
habitat	местообитание
musical	музыкальный
founder	основатель
coalition	коалиция
commentary	комментарий
equipment	снаряжение
mathematical	математический
fear	страх
example	пример
revolutionary	революционный
rice	рис
wikimedia	викимедиа
keyboards	клавиатуры
laboratories	лаборатории
lon_sec	lon_sec
architectural	архитектурный
baseball	бейсбол
gordon	гордон
assets	активы
position	положение
mechanism	механизм
series	серия
code	код
domestic	домашний
iron	железо
journal	журнал
nobody	никто
quantity	количество
technologies	технологии
departments	отделы
extinct	вымерший
maybe	maybe
license	лицензия
tourist	турист
smog	смог
weekly	недельный
garry	гарри
suffering	страдание
clothing	одежда
qualification	квалификация
peninsula	полуостров
high	высокий
boat	лодка
artillery	артиллерия
mechanical	механический
personally	лично
geography	география
numerous	многочисленный
billion	миллиард
conditions	условия
condition	условие
society	общество
cardinal	кардинал
language	язык
expected	ожидаемый
rooms	комнаты
deputy	заместитель
jointly	совместно
mixed	смешанный
morgan	морган
kharkov	харьков
subject	субъект
norway	норвегия
ideas	ideas
constitution	конституция
premiere	премьера
development	развитие
icons	иконы
governor	губернатор
reports	отчеты
love	любовь
block	блок
ludmila	людмила
summer	лето
ethnic	этнический
edited	отредактирован
creator	создатель
shakespeare	шекспир
morris	моррис
early	ранняя
dogs	собаки
sculptor	скульптор
chinese	китайский
runners	бегуны
hands	руки
jeff	джефф
thai	thai
ukase	указ
murders	убийства
fourth	четвёртый
champion	чемпион
cabinet	кабинет
communication	коммуникация
sculpture	скульптура
city	gorod
svg	svg
photographer	фотограф
system	система
subbasin	подбассейн
event	событие
positive	положительный
cotton	cotton
italy	италия
trainer	тренер
mass	масса
biography	biografija
edinburgh	эдинбург
yan	ян
sitting	сидящий
restaurant	ресторан
soft	мягкий
argument	аргумент
actively	активно
beach	пляж
trinity	троица
concentration	concentration
models	модели
thread	нить
northern	северный
friedrich	фридрих
famous	знаменитый
closer	closer
boys	мальчики
roberts	робертс
soldiers	солдаты
overall	overall
station	станция
dutch	голландский
eye	глаз
again	again
bay	бухта
bishops	епископы
lay	lay
roof	крыша
youtube	youtube
convention	конвенция
guinea	гвинея
dynamics	динамика
christ	христос
establishment	establishment
signed	подписанный
canton	кантон
unknown	неизвестный
leo	лео
success	успех
constellation	созвездие
tone	тон
presentation	презентация
jason	джейсон
impossible	невозможно
merger	слияние
offices	офисы
hair	волос
nikolayevna	николаевна
kennedy	кеннеди
nominations	номинации
potential	потенциал
beijing	пекин
warsaw	варшава
economic	экономический
phase	фаза
risk	риск
portugal	португалия
munich	мюнхен
sergeant	сержант
murphy	murphy
castle	замок
incubator	инкубатор
friday	пятница
depression	депрессия
wing	крыло
regiment	полк
gene	ген
eparchies	епархии
tokyo	токио
zones	зоны
relevant	relevant
other	другой
weekend	выходные
collective	коллективный
representatives	representatives
wolf	волк
footballer	футболист
cloud	облако
senators	сенаторы
cash	наличные
common	общий
voice	голос
phoenix	феникс
soil	почва
fund	фонд
accidentally	случайно
pakistan	пакистан
three	tri
dennis	деннис
then	тогда
exhibitions	выставки
oil	масло
businessman	бизнесмен
fields	поля
wikiproject	википроект
restaurants	рестораны
venice	венеция
mexico	мексика
character	характер
georgia	грузия
faculty	факультет
yellow	жёлтый
applications	приложения
evening	вечер
territories	territories
charlotte	шарлотта
resident	resident
variants	варианты
merit	заслуга
region	регион
plurality	множество
basin	бассейн
archive	архив
concept	концепция
terry	terry
film	фильм
facts	факты
format	формат
sisters	сёстры
jobs	jobs
rocket	ракет
next	следующий
korean	корейский
member	член
constitutional	конституционный
catalogue	каталог
necessary	необходимый
visual	визуальный
factory	фабрика
answer	ответ
franchise	франшиза
prague	прага
william	вильям
hot	горячий
