stile	style
trattato	traité
caratterizzato	caractérisé
fumo	fumée
visconti	visconti
importanza	importance
lingua	langue
acqua	eau
nazioni	nations
scrutinio	scrutin
praticamente	pratiquement
informatica	informatique
contare	compter
classifica	classement
giurista	juriste
battere	battre
scacchi	échecs
banda	bande
ludovico	ludovic
alberto	alberto
spiegazione	explication
comunale	communal
cambiamenti	changements
riviste	revues
fiori	fleurs
tenore	ténor
naso	nez
agenzia	agence
sorella	soeur
anteriore	antérieur
procedura	procédure
nazionali	nationales
leonardo	leonardo
riduzione	réduction
finanziamento	financement
profilo	profil
segnale	signal
successivamente	successivement
costruzioni	constructions
valore	valeur
estremità	extrémité
sino	sino
sposato	marié
inferiore	inférieur
milanese	milanaise
dipinti	peintures
estremo	extrême
cristoforo	christophe
finanziere	financier
brasile	brésil
parallelo	parallèle
candidato	candidat
infanzia	enfance
fenomeni	phénomènes
liberato	libéré
bretagna	bretagne
chiedere	demander
danimarca	danemark
audio	audio
sostenere	soutenir
garantire	garantir
canoni	canons
repubblica	république
fase	phase
sindrome	syndrome
naturale	naturel
croce	croix
educazione	éducation
democrazia	démocratie
amministrazione	administration
assicurare	assurer
armando	armando
gruppi	groupes
grado	degré
episodi	épisodes
politico	politicien
dovevano	devaient
costellazione	constellation
interprete	interprète
flotta	flotte
richieste	demandes
conoscenza	connaissance
filosofia	philosophie
scomparso	disparu
madeleine	madeleine
autorizzazione	autorisation
affluente	affluent
fondazione	fondation
mohamed	mohamed
lago	lac
sponsor	sponsor
mtv	mtv
presentazione	présentation
evolvendo	évoluant
voto	vote
usato	usagé
panorama	panorama
ministri	ministres
debole	faible
boulevard	boulevard
originale	original
ottenere	obtenir
inviato	envoyé
aprire	ouvrir
verifica	vérification
atp	atp
circoscrizioni	circonscriptions
scoprire	découvrir
quattordici	quatorze
malattia	maladie
annunciato	annoncé
giardini	jardins
chiuse	fermées
caffè	café
effetti	effets
commercio	commerce
cercato	cherché
aereo	aérien
finestre	fenêtres
tokyo	tokyo
evoluzione	évolution
coda	queue
esecutivo	exécutif
prigionieri	prisonniers
anomalia	anomalie
davis	davis
equilibrio	équilibre
gallimard	gallimard
viaggi	voyages
vuole	veut
ebraico	hébraïque
alto	haut
sconfitte	défaites
meccanica	mécanique
siena	sienne
funzione	fonction
tradizionali	traditionnels
monica	monique
hubert	hubert
ristorante	restaurant
moglie	épouse
equipaggio	équipage
traduttore	traducteur
eletti	élus
tocco	touche
lettere	lettres
rapporti	rapports
superato	surpassé
abbigliamento	vêtements
laterale	latéral
irlandese	irlandais
dappertutto	partout
cellula	cellule
pallone	ballon
austin	austin
ricerche	recherches
rivolta	révolte
arrivare	arriver
ideale	idéal
ruscello	ruisseau
sala	salle
sessuale	sexuel
maresciallo	maréchal
aiutare	aider
ruoli	rôles
occhio	œil
candidatura	candidature
paziente	patient
decisione	décision
tua	tua
materiali	matériaux
rispettare	respecter
riproduzione	reproduction
pianoforte	pianoforte
apparentemente	apparentement
stazione	station
archeologia	archéologie
accettare	accepter
pratiche	pratiques
esposizioni	expositions
avversari	adversaires
alsazia	alsace
america	amérique
sistemi	systèmes
scozia	écosse
liquido	liquide
lavoratori	travailleurs
conservatorio	conservatoire
amsterdam	amsterdam
valida	valide
scudo	escudo
passione	passion
sposo	époux
cerimonia	cérémonie
rito	rite
angeli	anges
seno	sein
acido	acide
toulouse	toulouse
fortuna	fortune
acciaio	acier
amato	aimé
venuto	venu
rosso	rouge
eugenio	eugène
utilizzazione	utilisation
positivo	positif
originariamente	originairement
rimettere	remettre
tradizionale	traditionnel
consultare	consulter
impossibile	impossible
attesa	attente
transizione	transition
luisa	louise
umani	humains
formazione	formation
accusa	accusation
rispondere	répondre
inseguire	poursuivre
cardinale	cardinal
paolo	paolo
hockey	hockey
uguaglianza	égalité
avrebbero	auraient
pirenei	pyrénées
dio	dieu
maschile	masculin
spagnolo	espagnol
penisola	péninsule
inserire	insérer
pioggia	pluie
successive	successive
faro	phare
albanese	albanais
arrestare	arrêter
bollettino	bulletin
previsto	prévu
nuovo	nouveau
avenida	avenue
calabria	calabre
lunga	longue
artistico	artistique
testimonianza	témoignage
enciclopedia	encyclopédie
digitale	numérique
terminato	terminé
finlandese	finlandais
orrore	horreur
galleria	galerie
possesso	possession
statistiche	statistiques
km/h	km/h
iscrizione	inscription
ispirato	inspiré
austria	autriche
wikimedia	wikimédia
motivi	motifs
orientamento	orientation
anime	anime
nazione	nation
esercizio	exercice
individuo	individu
cifra	chiffre
legge	loi
pdf	pdf
carolina	caroline
secondi	secondes
vincere	gagner
coscienza	conscience
internazionali	internationaux
harry	harry
sesto	sixième
agricolo	agricole
risposta	réponse
introduzione	introduction
marittimo	maritime
vienna	vienna
montagne	montagnes
scienze	sciences
truppa	troupe
riserve	réserves
famiglia	famille
invito	invitation
conferenza	conférence
mobile	mobile
ferrari	ferrari
articoli	articles
relativi	relatifs
monaco	monaco
enrico	enrico
metropolitana	métro
adamo	adam
britannico	britannique
democratico	démocratique
società	société
erede	héritier
sostituire	remplacer
proprietario	propriétaire
indipendenti	indépendants
presenza	présence
moneta	monnaie
blocchi	blocs
opzione	option
comando	commandement
altrimenti	autrement
girare	tourner
complesso	complexe
acquistato	acheté
danese	danois
socialista	socialiste
variabile	variable
automobile	automobile
immediatamente	immédiatement
oblast	oblast
unico	unique
composto	composé
buoni	bons
regola	règle
comunisti	communistes
menzione	mention
principali	principaux
terremoto	tremblement
articolo	article
distribuito	distribué
modalità	modalité
musicista	musicien
bellezza	beauté
fuga	fuite
successivi	successifs
capitolo	chapitre
personalità	personnalité
wayne	wayne
canto	chant
eseguito	exécuté
asia	asie
avvenire	avenir
marna	marne
danza	danse
file	fichier
didier	didier
conservatore	conservateur
microsoft	microsoft
battaglia	bataille
nomi	noms
polo	polo
disegno	dessin
ispirazione	inspiration
giochi	jeux
favorevoli	favorables
ombra	ombre
inserita	insérée
realizzati	réalisés
formazioni	formations
tendenza	tendance
biografico	biographique
provenienza	provenance
parola	parole
marseille	marseille
attivi	actifs
tempesta	tempête
australia	australie
cittadini	citoyens
visita	visite
precedentemente	précédemment
francofono	francophone
poveri	pauvres
tecnico	technicien
coste	côtes
barra	barre
tesi	thèse
organo	orgue
minore	mineur
perfettamente	parfaitement
bulgaria	bulgarie
oxford	oxford
corona	couronne
femmina	femmina
fascia	fascia
mondiali	mondiaux
ricevuto	reçu
esperto	expert
colombo	colombo
dominio	domaine
monete	monnaies
garibaldi	garibaldi
ripartiti	répartis
letto	lit
inferno	enfer
ferito	blessé
tecnologie	technologies
gigante	géant
comunista	communiste
maschera	masque
tirare	tirer
cuba	cuba
hamburgo	hambourg
cesare	césar
luciano	lucien
mestiere	métier
organismo	organisme
stelle	étoiles
nemici	ennemis
abitanti	habitants
professionale	professionnel
finestra	fenêtre
atto	atto
patrimonio	patrimoine
asteroidi	astéroïdes
varsavia	varsovie
ffffff	ffffff
ardenne	ardennes
candidati	candidats
venivano	venaient
apparizione	apparition
colore	couleur
cenni	cenni
associazioni	associations
risolvere	résoudre
rappresentante	représentant
economiche	économiques
carne	viande
eva	éva
riunione	réunion
bande	bandes
prete	prêtre
denti	dents
giappone	japon
installazioni	installations
operaio	ouvrier
napoleone	napoléon
amministrativo	administratif
emmanuele	emmanuel
attenzione	attention
personale	personnel
perdite	pertes
notorietà	notoriété
animatore	animateur
costantinopoli	constantinople
caricato	chargé
migliorare	améliorer
rivale	rival
ora	heure
intelligenza	intelligence
formato	format
xxx	xxx
nettamente	nettement
quantità	quantité
eseguita	exécutée
profondamente	profondément
slovacchia	slovaquie
@	@
combattere	combattre
platino	platine
omaggio	hommage
consacrata	consacrée
originali	originales
frase	phrase
bourbon	bourbon
novanta	nonante
pubblicati	publiés
?	?
misura	mesure
rischi	risques
compreso	compris
africana	africaine
tradotto	traduit
età	âge
arte	art
biblioteca	bibliothèque
prossimo	prochain
logica	logique
elevata	élevée
conoscere	connaître
fm	fm
pratica	pratique
americani	américains
difficili	difficiles
sceneggiatura	scénario
politica	politique,
nozione	notion
associati	associés
lamberto	lambert
torino	turin
ruote	roues
femminile	féminin
pino	pin
conflitti	conflits
orientale	oriental
serbia	serbie
italiana	italienne
tempo	tempo
pericolo	péril
distanza	distance
interviene	intervient
acquisizione	acquisition
rosario	rosaire
dovere	devoir
giornate	journées
provenza	provence
legami	liens
isola	île
guido	guido
feriti	blessés
erzegovina	herzégovine
siano	soient
immagine	image
venerdì	vendredi
filippine	philippines
interdizione	interdiction
jugoslavia	yougoslavie
sceneggiatore	scénariste
specialmente	spécialement
affrontare	affronter
navigazione	navigation
prezzo	prix
conoscenze	connaissances
viola	viole
desiderio	désir
giallo	jaune
aiuto	aide
margherita	marguerite
v	v
uffici	bureaux
viaggiatori	voyageurs
descritto	décrit
roger	roger
album	album
tecnologia	technologie
esperienza	expérience
accettato	accepté
episodio	épisode
tecniche	techniques
sombre	sombre
tournée	tournée
alfa	alfa
azione	action
maschili	masculins
giornale	journal
bobby	bobby
settimanale	hebdomadaire
nintendo	nintendo
religioso	religieux
resti	restes
norvegia	norvège
lloyd	lloyd
vai	vai
brunswick	brunswick
ernesto	ernesto
muore	meurt
frequenza	fréquence
robin	robin
nucleare	nucléaire
guardiano	gardien
navarra	navarre
consumo	consommation
tensione	tension
orientali	orientaux
amministratori	administrateurs
lupo	loup
allenamento	entraînement
identità	identité
architettura	architecture
testo	texte
mosca	mouche
fascista	fasciste
essi	ils
martire	martyr
fattoria	ferme
difetto	défaut
dintorni	environs
orlando	orlando
utilizzata	utilisée
umano	humain
rayon	rayon
romanzo	roman
animale	animal
venduti	vendus
graham	graham
individuali	individuels
ciclista	cycliste
basta	basta
parigina	parisienne
filippo	philippe
solo	seul
difesa	défense
popolari	populaires
professione	profession
club	club
montréal	montréal
liberi	libres
quinto	cinquième
\frac	\frac
segni	signes
gennaio	janvier
xavier	xavier
encore	encore
atelier	atelier
sindaco	maire
bartolomeo	bartolomeo
playstation	playstation
destra	droite
calciatori	footballeurs
organi	organes
dj	dj
impiegati	employés
attore	acteur
cultura	culture
opposto	opposé
tomba	tombe
moderni	modernes
blocco	bloc
culturali	culturales
editore	éditeur
arabo	arabe
concorso	concours
botanica	botanique
tempio	temple
internet	internet
processo	procès
determinare	déterminer
gamma	gamma
sostanze	substances
tf	tf
eddie	eddie
dodici	douze
ingegneria	ingénierie
maestri	maîtres
belgrado	belgrade
jimmy	jimmy
solido	solide
issus	issus
mercati	marchés
portoghese	portugais
spettatori	spectateurs
remix	remix
lezioni	leçons
rapidamente	rapidement
traduzione	traduction
scelte	choisies
barone	baron
neutro	neutre
soggetto	sujet
paura	peur
distrutta	détruite
sì	oui
chiamati	appelés
davvero	vraiment
maniera	manière
corporazione	corporation
giovani	jeunes
suddivisione	subdivision
concernant	concernant
mina	mine
caratteri	caractères
angelo	ange
riferimento	référence
privata	privée
carcere	carcere
québécois	québécois
rinomato	renommé
malgrado	malgré
genitori	géniteurs
felice	heureux
eseguire	exécuter
militante	militant
attacchi	attaques
gerarchia	hiérarchie
tappa	étape
contrasto	contraste
malato	malade
tibet	tibet
novembre	novembre
messico	mexique
mauvais	mauvais
emissione	émission
concentrazione	concentration
gordon	gordon
difficile	difficile
manchester	manchester
britannici	britanniques
chiudere	fermer
offerta	offre
rovine	ruines
antichi	anciens
partecipazione	participation
alain	alain
guidato	guidé
trasferito	transféré
popoli	peuples
alba	aube
comunemente	communément
murray	murray
danni	dommages
grazie	merci
fondamentali	fondamentaux
conferenze	conférences
volontari	volontaires
medicina	médecine
sorelle	sœurs
fondamentale	fondamental
inserito	inséré
robot	robot
minuto	minute
canone	canon
bibbia	bible
regime	régime
associato	associé
dossier	dossier
ritirata	retraite
dicendo	disant
concessione	concession
genetica	génétique
futuro	futur
sconosciuto	inconnu
maine	maine
colonnello	colonel
grigio	gris
materiale	matériel
confederazione	confédération
diego	diego
dimostrato	démontré
miniserie	minisérie
impedire	empêcher
laghi	lacs
spiegare	expliquer
identico	identique
automaticamente	automatiquement
cliente	client
nero	noir
europeo	européen
santo	saint
indonesia	indonésie
firenze	florence
antico	antique
studente	étudiant
cattolici	catholiques
modificazione	modification
recente	récent
vergine	vierge
spagnoli	espagnols
militare	militaire
ascensione	ascension
difficoltà	difficulté
accusato	accusé
soldati	soldats
riconosciuta	reconnue
wikipedia	wikipédia
copiato	copié
tenere	tenir
negoziazioni	négociations
manoscritto	manuscrit
dedicata	dédiée
afelio	aphélie
russia	russie
destro	destro
riconosciuto	reconnu
procuratore	procureur
calendario	calendrier
buono	bon
esilio	exil
suo	suo
tante	tantes
completamente	complètement
sviluppare	développer
opinione	opinion
pesanti	lourds
considerazione	considération
cattolico	catholique
spedizione	expédition
recentemente	récemment
corrente	courant
capitoli	chapitres
pacifico	pacifique
creando	créant
merito	mérite
atleta	athlète
descrizione	description
contemporanea	contemporaine
ritmo	rythme
mulini	moulins
amicizia	amitié
todd	todd
perduto	perdu
amministratore	administrateur
moto	moto
banche	banques
prestazioni	prestations
nîmes	nîmes
decorazione	décoration
istituito	institué
precisamente	précisément
affari	affaires
distinzioni	distinctions
soppressione	suppression
inverno	hiver
organizzare	organiser
html	html
pubblicazioni	publications
ministro	ministre
esperti	experts
fatta	faite
sostituita	remplacée
rilievo	relief
perdita	perte
basilica	basilique
voluto	voulu
napoli	naples
concetto	concept
thierry	thierry
arbitraggio	arbitrage
progetto	projet
inventario	inventaire
considerato	considéré
grotta	grotte
promuovere	promouvoir
libreria	librairie
carbone	charbon
pochi	pochi
composti	composés
giudice	juge
deceduto	décédé
riccardo	riccardo
generi	genres
progressivamente	progressivement
fasi	phases
vetrina	vitrine
semplicemente	simplement
michele	michele
diviso	divisé
ali	ailes
trattamento	traitement
pagamento	paiement
bocca	bouche
lublino	lublin
ducato	ducat
studiare	étudier
madrid	madrid
comunicazioni	communications
pronto	pronto
eponimo	éponyme
detto	dit
a	a
confronto	confrontation
spaziale	spatiale
peggio	pire
ritornare	revenir
lunedì	lundi
drago	dragon
dopo	après
rappresentazione	représentation
feudo	fief
archiviata	archivée
dichiarato	déclaré
fuori	dehors
scozzese	écossais
insetti	insectes
corse	corses
giovanile	juvénile
pressa	presse
interesse	intérêt
luogo	lieu
antonio	antonio
diritti	droits
clan	clan
stima	estime
notabili	notables
problema	problème
valori	valeurs
avvocato	avocat
accessibile	accessible
matematica	mathématique
vieni	viens
xls	xls
consenso	consensus
elettricità	électricité
settimana	semaine
iii	iii
giardino	jardin
abbazia	abbaye
kevin	kevin
particolarmente	particulièrement
figlia	fille
urbano	urbain
disputa	dispute
intermediario	intermédiaire
riflessione	réflexion
installazione	installation
ingegneri	ingénieurs
visitatori	visiteurs
muri	murs
vendetta	vengeance
reliant	reliant
redditi	revenus
lanciare	lancer
risorse	ressources
signora	madame
fiumi	rivières
avversario	adversaire
cinematografico	cinématographique
morta	morte
realizzazione	réalisation
douglas	douglas
federale	fédéral
strategia	stratégie
sostanza	substance
attori	acteurs
strutture	structures
alfredo	alfredo
scuola	école
salvare	sauver
restaurazione	restauration
profonda	profonde
bruno	brun
feat	feat
padova	padoue
rieletto	réélu
visibile	visible
proposto	proposé
regolarmente	régulièrement
cristiano	chrétien
amm	amm
khan	khan
messa	messe
operazioni	opérations
altare	autel
cavalleria	cavalerie
augusto	auguste
installato	installé
attaccare	attaquer
presa	prise
perù	pérou
stati	états
genio	génie
enciclopedico	encyclopédique
piante	plantes
ragione	raison
feste	fêtes
metropoli	métropole
bizantino	byzantin
scultore	sculpteur
bacino	bassin
maurizio	maurice
terra	terre
il	le
membri	membres
ospedale	hôpital
francesco	françois
lavorare	travailler
proposte	propositions
aquila	aigle
quale	quel
uguale	égal
distinzione	distinction
ragni	araignées
italiano	italien
suivi	suivi
impero	empire
stadio	stade
eroe	héros
maria	marie
bloccato	bloqué
ravenna	ravenne
critica	critique
guardia	garde
sebastiano	sebastien
enciclopedici	encyclopédiques
elisabetta	élisabeth
traversata	traversée
limiti	limites
sabbia	sable
piemonte	piémont
freddo	froid
dotato	doué
camerun	cameroun
foglia	feuille
pietra	pierre
seconda	seconde
dentro	dedans
studenti	étudiants
presidenziale	présidentielle
gotico	gothique
culturale	culturel
scienza	science
teologo	théologien
eventuali	éventuels
risultati	résultats
necessità	nécessité
parigi	paris
contribuzione	contribution
mercante	marchand
elementi	éléments
possibilità	possibilité
mussolini	mussolini
tu	toi
ciascuno	chacun
familiare	familier
corde	cordes
mille	mille
tardi	tard
già	déjà
considerata	considérée
documento	document
immagini	images
primavera	printemps
dotata	dotée
mandato	mandat
rimasta	restée
ita	ita
gene	gène
dipendenti	dépendants
ritirare	retirer
bronzo	bronze
fondatore	fondateur
esecuzione	exécution
aeronautica	aéronautique
cimitero	cimetière
accogliere	accueillir
forte	fort
fatti	faits
collaborazione	collaboration
legato	legato
considerati	considérés
cucina	cuisine
greca	grecque
persino	persin
momenti	moments
italiens	italiens
giudiziario	judiciaire
nullo	nul
sperimentale	expérimental
modena	modène
programma	programme
essenza	essence
partecipato	participé
cinquanta	cinquante
minaccia	menace
austriaco	autrichien
colonia	colonie
sostegno	soutien
oggetto	objet
assai	assai
congregazione	congrégation
affermazione	affirmation
leggero	léger
presentato	présenté
facilmente	facilement
produzione	production
friedrich	friedrich
volontà	volonté
varietà	variété
scorta	escorte
bianchi	bianchi
centinaia	centaines
alice	alice
nazionalità	nationalité
hamilton	hamilton
studiato	étudié
trattati	traités
istituzione	institution
illustrazioni	illustrations
svedese	suédoise
manoscritti	manuscrits
cuore	coeur
silenzio	silence
tipicamente	typiquement
piccola	petite
raro	rare
trovato	trouvé
romagna	romagne
bordo	bord
visione	vision
tipico	typique
domenica	dimanche
fabbrica	fabrique
veste	veste
violenza	violence
straniera	étrangère
mani	mains
relativo	relatif
finito	fini
dizionario	dictionnaire
vacanze	vacances
tradizione	tradition
mario	mario
difendere	défendre
intitolato	intitulé
metodo	méthode
divinità	divinité
orbita	orbite
banca	banque
foto	photo
saga	saga
cantone	canton
eliminato	éliminé
augmentation	augmentation
blu	bleu
spirituale	spirituel
segreto	secret
tedeschi	allemands
vancouver	vancouver
uccello	oiseau
biologia	biologie
spalle	épaules
discussioni	discussions
organizzazione	organisation
costante	constante
salotto	salon
bâtiments	bâtiments
sovietici	soviétiques
blues	blues
scrittrice	écrivaine
effettuare	effectuer
spazi	espaces
cancro	cancer
militari	militaires
titolare	titulaire
cominciare	commencer
segreti	secrets
schema	schéma
residenza	résidence
claudio	claudio
punti	points
orchestra	orchestre
riserva	réserve
borgogna	bourgogne
avete	avez
corrispondente	correspondant
posta	poste
fiorentina	florentine
pagina	page
giornalisti	journalistes
alcol	alcool
braccio	bras
possibili	possibles
cantata	cantate
popolarità	popularité
base	base
franchi	franchi
accademia	académie
regno	royaume
funzioni	fonctions
fotografia	photographie
ci	ci
collo	col
livello	niveau
pietre	pierres
combattenti	combattants
ospiti	hôtes
conferma	confirmation
ricevere	recevoir
verificare	vérifier
paesaggio	paysage
culto	culte
attività	activité
fisico	physique
popolare	populaire
marittimi	maritimes
congresso	congrès
settore	secteur
diana	diane
vecchio	vieux
utili	utiles
natale	noël
classici	classiques
lavoro	travail
testimonianze	témoignages
specifici	spécifiques
lasciare	laisser
serra	serre
correnti	courants
nba	nba
poitou	poitou
riva	rive
meccanismo	mécanisme
bbc	bbc
madagascar	madagascar
borghese	bourgeois
fratelli	frères
giornali	journaux
ovest	ouest
bella	belle
vedere	voir
discografico	discographique
scrittore	écrivain
omonimia	homonymie
alessandria	alexandrie
titoli	titres
guadagnato	gagné
corea	coree
alta	haute
televisiva	télévisée
diavolo	diable
religiose	religieuses
depositato	déposé
acquisto	achat
leggera	légère
hollywood	hollywood
mba	mba
umanità	humanité
problemi	problèmes
scopritore	découvreur
roberto	roberto
filmografia	filmographie
sportivi	sportifs
senegal	sénégal
osservazione	observation
s	s
missione	mission
maggiore	majeur
corretta	corrigée
promozionale	promotional
revisione	révision
dubbio	doute
principi	principes
italo	italo
geolocalizzazione	géolocalisation
rottura	rupture
ebreo	juif
tutto	tout
lettori	lecteurs
centrali	centrales
valutare	évaluer
azzurro	azur
relativamente	relativement
boris	boris
ordinato	ordonné
miliardi	milliards
speciale	spécial
finire	finir
oceano	océan
isole	îles
imperiale	impérial
portare	porter
demografico	démographique
sarebbero	seraient
massimo	maximum
atti	actes
sfida	défie
notevolmente	notablement
rapporto	rapport
miglioramento	amélioration
sinfonia	symphonie
contenuto	contenu
nobile	noble
anima	âme
asti	asti
preti	prêtres
colonne	colonnes
esattamente	exactement
piena	pleine
tutta	toute
decisioni	décisions
sabato	samedi
interpretazione	interprétation
pallavolo	pallavolo
prioria	prieuré
uomo	homme
medico	médecin
condanna	condamnation
operativo	opératif
monaci	moines
prigioniero	prisonnier
alimentare	alimentaire
russo	russo
divenire	devenir
cielo	ciel
ridotto	réduit
fiat	fiat
compositore	compositeur
vietato	interdit
voce	voix
pesci	poissons
totalità	totalité
chiara	claire
uefa	uefa
detentore	détenteur
escalier	escalier
associazione	association
piccoli	petits
comparsa	comparse
pista	piste
fine	fin
parziale	partiel
catena	chaîne
ungheria	hongrie
ottica	optique
trama	trame
traffico	trafic
cima	cime
citare	citer
faceva	faisait
riconoscimento	reconnaissance
spada	épée
pressione	pression
patriota	patriote
giorgio	georges
luigi	louis
boston	boston
linguistica	linguistique
specie	espèces
york	york
londra	londres
segnalazione	signalisation
manifestazione	manifestation
variante	variante
dettagli	détails
cerchio	cercle
bisogni	besoins
servizi	services
miami	miami
artisti	artistes
giornalista	journaliste
elena	elena
universale	universel
roux	roux
realtà	réalité
cambiamento	changement
conseguenza	conséquence
accetta	accepte
calciatore	footballeur
partire	partir
mese	mois
americano	americain
schiavi	esclaves
locali	locaux
imprenditore	entrepreneur
michigan	michigan
oriente	oriente
scientifico	scientifique
considerare	considérer
amico	ami
formula	formule
corridore	coureur
gestione	gestion
amici	amis
estensione	étendue
novità	nouveauté
musiciens	musiciens
ossia	ossia
colpo	coup
poesia	poésie
rivista	revue
rifugio	refuge
misure	mesures
daniel	daniel
criminale	criminel
dialogo	dialogue
quando	quand
johnny	johnny
impegno	engagement
atleti	athlètes
volume	volume
classifiche	classements
garonna	garonne
bosco	bois
nozze	noces
attualità	actualité
laureato	lauréat
dvd	dvd
costantino	constantin
errori	erreurs
tramvia	tramway
sara	sara
finalista	finaliste
giudizio	jugement
olivo	olivier
milione	million
solista	soliste
certa	certaine
truppe	troupes
usati	usagés
bianche	blanches
onda	onde
wimbledon	wimbledon
scienziati	scientifiques
intervento	intervention
venendo	venant
ispettore	inspecteur
vento	vent
voleva	voulait
ordine	ordre
abate	abbé
avanzamento	avancement
castello	chateau
lourdes	lourdes
terzi	tiers
relazione	relation
indice	indice
sicuro	sûr
opere	oeuvres
condannato	condamné
peso	poids
nave	nef
pagare	payer
tribù	tribu
incendio	incendie
università	université
appoggio	appui
compagno	compagnon
scomparsa	disparition
soggetti	sujets
territori	territoires
zero	zéro
successore	successeur
margine	marge
sconosciuta	inconnue
romanziere	romancier
fauna	faune
circoscrizione	circonscription
occupa	occupe
riprendere	reprendre
danno	dommage
lp	lp
conosciuta	connue
cronologia	chronologie
campbell	campbell
vantaggio	avantage
agente	agent
giasone	jason
caen	caen
circolare	circulaire
sezione	section
boulogne	boulogne
finanziaria	financière
volere	vouloir
internazionale	internationale
rurale	rural
racconti	récits
howard	howard
lunghezza	longueur
gentile	gentil
stuart	stuart
visibili	visibles
pistola	pistolet
giugno	juin
rocca	roche
convocato	convoqué
nodo	nœud
ambasciatore	ambassadeur
abitante	habitant
viva	vive
destino	destin
arcivescovo	archevêque
motivazioni	motivations
razza	race
ottenuto	obtenu
maschio	mâle
straniero	étranger
idea	idée
bagni	bains
batteria	batterie
terry	terry
assumere	assumer
notte	nuit
lettera	lettre
imparare	apprendre
toscana	toscane
facciata	façade
filosofo	philosophe
canada	canada
racconto	récit
successione	succession
mediterraneo	méditerranéen
inferiori	inférieures
accademico	académique
separazione	séparation
eccellenza	excellence
elettronica	électronique
trattare	traiter
greci	grecs
alpi	alpes
epoca	époque
corsa	course
arcipelago	archipel
repertorio	répertoire
veglia	veille
deputati	députés
cena	dîner
occasioni	occasions
capelli	cheveux
dichiarazione	déclaration
disciplina	discipline
adattamento	adaptation
idee	idées
diplomatico	diplomatique
parchi	parcs
io	je
insegnante	enseignant
elettorale	électorale
scambio	échange
o	o
accoglienza	accueil
sicurezza	sécurité
esistenti	existants
magia	magie
seguita	suivie
preparazione	préparation
neat	neat
staffetta	estafette
sorpresa	surprise
riuscito	réussi
pezzo	pièce
esseri	êtres
vittima	victime
speranza	espérance
prefazione	préface
santi	saints
emilia	émilie
marcia	marche
coalizione	coalition
delegazione	délégation
aosta	aoste
non	non
lanciato	lancé
breve	brève
provvisorio	provisoire
credito	crédit
principe	prince
editoriale	éditorial
denominato	dénommé
mostrare	montrer
responsabili	responsables
santuario	sanctuaire
miguel	miguel
azzardo	hasard
vaticano	vatican
sofia	sofia
autrefois	autrefois
giustizia	justice
araldica	héraldique
quelli	ceux
sicuramente	sûrement
lecce	lecce
asteroide	astéroïde
straniere	étrangères
accento	accent
lisbona	lisbonne
sacro	sacré
prendere	prendre
percentuale	pourcentage
confluenza	confluence
contadini	paysans
affreschi	fresques
documentazione	documentation
dordogna	dordogne
moore	moore
altro	autre
arbitro	arbitre
cratere	cratère
testamento	testament
ancona	ancône
latino	latino
concezione	conception
vf	vf
drammaturgo	dramaturge
rouen	rouen
cronaca	chronique
lausanne	lausanne
evidentemente	évidemment
biacco	biais
buonaparte	bonaparte
assolutamente	absolument
lì	là
realizzare	réaliser
bambini	bambins
gerusalemme	jérusalem
citta	cité
maniero	manoir
canzoni	chansons
ufficiali	officiers
,	,
ridurre	réduire
capire	comprendre
youtube	youtube
responsabilità	responsabilité
larghezza	largeur
occasione	occasion
cercare	chercher
quindici	quinze
differenze	différences
durata	durée
motori	moteurs
prevalentemente	principalement
discorso	discours
nessuno	nessuno
effetto	effet
atlantico	atlantique
fenomeno	phénomène
alimentazione	alimentation
derivati	dérivés
spazio	espace
rimanere	rester
minimo	minimum
disegni	dessins
signori	seigneurs
divisione	division
loir	loir
arrivano	arrivent
istituzioni	institutions
parigino	parisien
duchessa	duchesse
deputato	député
selezionato	sélectionné
software	logiciel
controllare	contrôler
significante	signifiant
maxi	maxi
recenti	récents
completare	compléter
esclusivamente	exclusivement
vicini	voisins
calais	calais
partecipante	participant
cose	choses
obiettivo	objectif
germanico	germanique
cambridge	cambridge
uns	uns
achille	achille
spettacolo	spectacle
piccardia	picardie
oggetti	objets
pozzo	puits
livorno	livourne
servizio	service
soli	soli
credere	croire
vissuto	vécu
avventura	aventure
esempi	exemples
autunno	automne
apparire	apparaître
polizia	police
partecipanti	participants
autostrada	autoroute
dissoluzione	dissolution
editrice	éditrice
•	•
ps	ps
dinastia	dynastie
fotografo	photographe
clip	clip
incidente	incident
competenze	compétences
assunto	assumé
velocità	vitesse
vedova	veuve
differenza	différence
favorevole	favorable
curva	courbe
elettrici	électriques
wiki	wiki
convento	couvent
scuole	écoles
rispettivamente	respectivement
sultano	sultan
leggermente	légèrement
segno	signe
georgia	géorgie
eliminazione	élimination
alessandro	alexandre
raccolta	récolte
tastiera	clavier
leopoldo	léopold
tratti	traits
strasburgo	strasbourg
coreano	coréen
sciopero	grève
ettore	ettore
citazione	citation
navi	navires
spostamento	déplacement
detective	détective
sorti	sorti
chicago	chicago
vigore	vigueur
battente	battant
registrazione	enregistrement
suite	suite
equivalente	équivalent
insegnamento	enseignement
accesso	accès
architetto	architecte
barca	bateau
vocale	vocale
ella	elle
gioventù	jeunesse
comuni	communes
intervenire	intervenir
proporsi	proposer
municipale	municipal
introdotto	introduit
lanciata	lancée
aggiungere	ajouter
infinito	infini
specialista	spécialiste
municipalità	municipalité
bloccaggio	blocage
laboratorio	laboratoire
lewis	lewis
collaborato	collaboré
scena	scène
località	localité
milano	milan
fortemente	fortement
guidata	guidée
filo	filo
einaudi	einaudi
carabinieri	carabiniers
conto	compte
potere	pouvoir
trasferita	transférée
ricordi	souvenirs
stretto	étroit
cinese	chinois
storie	histoires
memorie	mémoires
établi	établi
gallina	poule
antichità	antiquités
mettendo	mettant
disponibili	disponibles
programmazione	programmation
percussioni	percussions
moderno	moderne
cemento	ciment
produttori	producteurs
ambito	ambitus
colori	couleurs
difensore	défenseur
iran	iran
esposizione	exposition
piedi	pieds
liberazione	libération
esploratore	explorateur
consiste	consiste
reddito	revenu
inseguimento	poursuite
zelanda	zélande
autore	auteur
copia	copie
alias	alias
minnesota	minnesota
tipologia	typologie
hc	hc
duca	duc
appartenenza	appartenance
veniva	venait
bretone	breton
fernando	fernando
applicazioni	applications
ribelli	rebelles
bob	bob
libri	livres
ramo	rameau
ontario	ontario
bandiera	drapeau
ufficio	bureau
privati	privés
duro	dur
poteri	pouvoirs
continuo	continuo
estremamente	extrêmement
compagnia	compagnie
sconfitta	défaite
nancy	nancy
lotta	lutte
foglie	feuilles
divennero	devinrent
statua	statue
appartiene	appartient
malauguratamente	malheureusement
letteratura	littérature
musei	musées
conservare	conserver
superare	surpasser
eccezione	exception
altrove	ailleurs
esordio	début
suonare	sonner
industria	industrie
fondatori	fondateurs
russi	russi
renault	renault
teorema	théorème
%a	%a
normalmente	normalement
riedizione	réédition
vittoria	victoire
bruxelles	brussels
autant	autant
testa	tête
febbraio	février
menzionato	mentionné
pubblicità	publicité
chiese	églises
munich	munich
crescita	croissance
vladimir	vladimir
creatore	créateur
vincenzo	vincenzo
adulto	adulte
conduttore	conducteur
giuria	jury
varianti	variantes
fattore	facteur
adriano	adriano
comunità	communauté
inchiesta	enquête
xviie	xviie
luglio	juillet
ciò	ça
economia	économie
antenna	antenne
parlamentare	parlementaire
superficie	surface
operatore	opérateur
normale	normal
mitologia	mythologie
udine	udine
situazione	situation
malattie	maladies
utile	utile
ricerca	recherche
distribuzione	distribution
fabrizio	fabrizio
ulteriori	ultérieures
giocando	jouant
diploma	diplôme
iniziato	initié
ricordo	souvenir
perugia	pérouse
marmo	marbre
strade	rues
mito	mythe
ministero	ministère
carlotta	charlotte
jerry	jerry
calcolo	calcul
arancia	orange
sufficiente	suffisant
discesa	descente
cattedrale	cathédrale
concerto	concerto
madonna	madone
appartenente	appartenant
alleati	alliés
cannone	cannon
collina	colline
professionisti	professionnels
classificazione	classification
ferrovia	ferrovia
vecchia	vieille
iniziale	initiale
villaggi	villages
manuale	manuel
principato	principauté
teoria	théorie
nota	note
equatore	équateur
ultimo	ultime
prova	épreuve
aggiunto	ajouté
borsa	bourse
perdere	perdre
pesca	pêche
storico	historique
fabio	fabio
esperienze	expériences
interessato	intéressé
esistenza	existence
jackson	jackson
motivo	motif
radici	racines
generazione	génération
tutela	tutelle
semplice	semplice
tecnici	techniciens
uova	œufs
innamorato	amoureux
potente	puissant
fiducia	fiducie
mezzo	mezzo
canadesi	canadiens
nostro	nostre
comportamento	comportement
ferdinando	ferdinand
contatto	contact
veicoli	véhicules
personalmente	personnellement
attuale	actuel
invernali	hivernaux
accedere	accéder
esplosione	explosion
grossa	grosse
eccentricità	excentricité
segnalare	signaler
campionessa	championne
seguono	suivent
eure	eure
patto	pacte
treno	train
indiana	indienne
distruggere	détruire
territorio	territoire
brigata	brigade
chiave	clé
giapponese	japonais
chiaro	clair
morti	morts
supplementare	supplémentaire
documentario	documentaire
segretario	secrétaire
ipotesi	hypothèse
#ffffff	#ffffff
maestria	maîtrise
anniversario	anniversaire
bassista	bassiste
amica	amie
inghilterra	angleterre
veicolo	véhicule
conservazione	conservation
tecnica	technique
luoghi	lieux
eventuale	éventuel
ricorso	recours
rappresentazioni	représentations
sposata	mariée
sydney	sydney
festa	fête
signore	seigneur
erba	herbe
genere	genre
pio	pieux
svg	svg
musiche	musiques
contemporaneo	contemporain
vittorio	vittorio
ritirato	retiré
esemplare	exemplaire
rami	rameaux
entità	entité
scrivere	écrire
ici	ici
regioni	régions
serbo	serbe
resistenza	résistance
opposizione	opposition
arrivato	arrivé
pelle	peau
generico	générique
attivo	actif
chiuso	fermé
essenziale	essentiel
fantasma	fantôme
giuseppe	giuseppe
borgo	bourg
esterno	extérieur
spiaggia	plage
proprietari	propriétaires
frontiera	frontière
onore	honneur
storici	historiens
artiglieria	artillerie
onorato	honoré
senso	sens
stanley	stanley
iniziativa	initiative
uscita	sortie
modifiche	modifications
illustre	illustre
iraq	irak
missioni	missions
nord	nord
menato	mené
adottato	adopté
edizione	édition
iata	iata
voilà	voilà
sanremo	sanremo
meridionale	méridional
radio	radio
passato	passé
patria	patrie
andare	ander
paradiso	paradis
algeria	algérie
pubblicare	publier
ecologia	écologie
altitudine	altitude
ohio	ohio
sei	six
assoluta	absolue
effettivo	effectif
toponimo	toponyme
saluto	salut
radice	racine
gastone	gaston
camille	camille
sportivo	sportif
niente	rien
battaglie	batailles
illinois	illinois
ciascuna	chacune
grave	grave
uomini	hommes
vosgi	vosges
aggiunta	ajout
collegio	collège
anderson	anderson
pittori	peintres
brevi	brèves
vapore	vapeur
carattere	caractère
norvegese	norvégien
battelli	bateaux
parlamento	parlement
armi	armes
bonus	bonus
cilindri	cylindres
catturato	capturé
ammesso	admis
matrice	matrice
interpretato	interprété
dessous	dessous
allo	allo
rocce	roches
quartieri	quartiers
necessario	necessaire
aprile	avril
accordo	accord
venezuela	venezuela
interni	intérieurs
gallo	coq
parete	paroi
partigiano	partisan
intenzione	intention
prussia	prusse
indirizzo	adresse
condizione	condition
fuggire	fuir
attitudine	attitude
muro	mur
reputazione	réputation
nera	noire
assenza	absence
dimora	demeure
dipartimenti	départements
stazioni	stations
wilaya	wilaya
costruire	construire
abbandonare	abandonner
pittura	peinture
cristiana	chrétienne
aura	aura
poitiers	poitiers
affare	affaire
bilancio	bilan
spirito	esprit
parlare	parler
cristina	christine
probabilità	probabilité
inizialmente	initialement
scegliere	choisir
integrato	intégré
formante	formant
oscar	oscar
rolandi	roland
pari	pari
ricercatori	chercheurs
orléans	orléans
dicembre	décembre
basso	basse
vicinanze	voisinages
struttura	structure
organismi	organismes
implica	implique
aio	ai
protetto	protégé
origine	origine
episcopale	épiscopal
sapere	savoir
comune	commune
umorismo	humour
marco	marco
repubblicano	républicain
sentimenti	sentiments
allestimento	aménagement
entrare	entrer
conclusione	conclusion
allievo	élève
specifico	spécifique
piacere	plaisir
frutta	fruits
conflitto	conflit
vita	vie
contro	contre
frammenti	fragments
catalogna	catalogne
componenti	composants
dunque	donc
#f	#f
acque	eaux
situazioni	situations
romantico	romantique
sottomesso	soumis
quarta	quarte
vini	vins
vino	vin
punta	pointe
africa	afrique
pubblicate	publiées
anversa	anvers
fossa	fosse
sesso	sexe
angela	angela
pieno	plein
imho	imho
passaggio	passage
lombardia	lombardie
definito	défini
sempre	toujours
pirati	pirates
qualificazione	qualification
obiettivi	objectifs
mantenere	maintenir
decennio	décennie
sovrani	souverains
inciso	incisé
germania	germanie
chiusura	fermeture
chiesa	église
lui	lui
serata	soirée
armenia	arménie
completa	complète
sorgente	source
parrocchia	paroisse
wilson	wilson
corte	cour
apertura	ouverture
continuare	continuer
foro	forum
imprese	entreprises
hitler	hitler
discutere	discuter
parco	parc
zurigo	zurich
assassino	assassin
amministrativamente	administrativement
estratto	extrait
mettere	mettre
dotati	dotés
sindacato	syndicat
turchia	turquie
dolore	douleur
jonathan	jonathan
funzionamento	fonctionnement
costruttore	constructeur
raccolte	recueils
montante	montant
ligure	ligure
giacobbe	jacob
accordi	accords
commissione	commission
anello	anneau
consigliere	conseiller
attuali	actuels
cirillico	cyrillique
canadese	canadien
atmosfera	atmosphère
savoia	savoie
sessanta	soixante
biografia	biographie
niccolò	niccolò
disney	disney
avanzata	avancée
equipaggiamento	équipement
vengono	viennent
omicidio	homicide
mercato	marché
incontri	rencontres
novelle	nouvelles
dijon	dijon
allenatore	entraîneur
interpreti	interprètes
alpino	alpin
arrêté	arrêté
canali	canaux
stagioni	saisons
pezzi	pièces
artista	artiste
servire	servir
efficacia	efficacité
statuto	statut
camere	chambres
esistente	existant
compagnie	compagnies
jeff	jeff
argomento	argument
grazia	grâce
campione	champion
comunitaria	communautaire
aisne	aisne
categoria	catégorie
grenoble	grenoble
guglielmo	guglielmo
bertrando	bertrand
vedute	vues
verona	vérone
contributori	contributeurs
video	vidéo
via	voie
crisi	crise
cantautrice	chanteuse
formata	formée
xviiie	xviiie
stella	étoile
franz	franz
dono	don
giustamente	justement
nove	neuf
aeroplani	avions
occidentale	occidental
singolare	singulier
coppie	couples
fossili	fossiles
discendenti	descendants
ebbero	eurent
scoperte	découvertes
palmares	palmarès
ordini	ordres
✉	✉
dea	déesse
baia	baie
apprendimento	apprentissage
telefono	téléphone
decorazioni	décorations
nipote	neveu
australiano	australien
cordialmente	cordialement
versante	versant
senatore	sénateur
variazioni	variations
sfera	sphère
marcatori	marqueurs
marchese	marquis
etichetta	étiquette
agricoltura	agriculture
centri	centres
verde	vert
infine	enfin
materia	matière
ritorno	retour
vescovi	évêques
personaggio	personnage
creata	créée
commissario	commissaire
allemanda	allemande
petrolio	pétrole
conquistare	conquérir
giulia	giulia
spese	dépenses
otto	huit
pannelli	panneaux
progresso	progrès
ridotta	réduite
passare	passer
berlino	berlin
doveva	devait
catene	chaînes
uccelli	oiseaux
letterario	littéraire
dimostrare	démontrer
mauvaise	mauvaise
colonie	colonies
ufficialmente	officiellement
costruzione	construction
produzioni	productions
rosa	rose
armato	armé
efficace	efficace
guida	guide
livelli	niveaux
universitari	universitaires
virus	virus
)	)
villanova	villeneuve
ragazzi	garçons
controllo	contrôle
bianco	blanc
tornei	tournois
pagine	pages
utenti	utilisateurs
realizzate	réalisées
consiglio	conseil
trovare	trouver
limoges	limoges
pensare	penser
invasione	invasion
occupare	occuper
regina	reine
radicale	radicaux
documenti	documents
lunghe	longues
partigiani	partisans
caterina	catherine
filadelfia	philadelphie
interventi	interventions
vendite	ventes
simbolo	symbole
attaché	attaché
rimarcare	remarquer
manifesto	manifeste
ottobre	octobre
integrazione	intégration
civiltà	civilisation
critiche	critiques
trazione	traction
google	google
utilizzati	utilisés
isabella	isabelle
ago	ago
teatrale	théâtral
fpu	fpu
illustrazione	illustration
montpellier	montpellier
pittore	peintre
noi	nous
coppia	couple
fusione	fusion
denominazione	dénomination
rapper	rappeur
cristiani	chrétiens
ceduto	cédé
giusto	juste
sequenza	séquence
cugino	cousin
differente	différent
martina	martine
patriarca	patriarche
agglomerazione	agglomération
massachusetts	massachusetts
raramente	rarement
ufficiale	officier
avvenimenti	événements
corrispondenza	correspondance
fascismo	fascisme
albero	arbre
anno	annee
vera	vraie
corpo	corps
dettaglio	détail
undici	onze
abbandonato	abandonné
impressione	impression
lazio	lazio
organizzata	organisée
famiglie	familles
turco	turc
rivoluzionario	révolutionnaire
definitivamente	définitivement
buongiorno	bonjour
gloria	gloire
ritrovare	retrouver
giancarlo	giancarlo
collettivo	collectif
limite	limite
disegnatore	dessinateur
vicina	voisine
troppo	trop
trieste	trieste
inclinata	inclinée
bene	bien
leggenda	légende
matematico	mathématicien
lee	lee
cavallo	cheval
aspettare	attendre
eliminare	éliminer
viaggio	voyage
dominazione	domination
direzione	direction
alberi	arbres
entrata	entrée
produttore	producteur
coppa	coupe
carlo	carlo
protagonisti	protagonistes
annuncio	annonce
frequentemente	fréquemment
urgenza	urgence
till	till
battuto	battu
particolari	particulières
ebrei	juifs
massiccio	massif
aperto	ouvert
legame	lien
bolzano	bolzano
apr	apr
osservazioni	observations
signoria	seigneurie
specializzata	spécialisée
nei	nei
facoltà	faculté
romanzi	romans
distruzione	destruction
ruota	roue
zonizzazione	zonage
giunti	joints
luce	lumière
generalmente	généralement
vescovo	évêque
gonzaga	gonzague
versioni	versions
occhi	yeux
ferrara	ferrara
precedenti	précédents
consacrato	consacré
suicidio	suicide
québec	québec
piccole	petites
argomenti	arguments
assoluto	absolu
irlanda	irlande
impiegato	employé
libertà	liberté
urbana	urbaine
reggimento	régiment
vogliono	veulent
mattino	matin
assassinio	assassinat
verità	vérité
benedetto	bénédict
davide	david
maggiori	majeurs
dna	dna
spagna	espagne
campionati	championnats
xvii	xvii
secondario	secondaire
configurazione	configuration
nuovi	nouveaux
ritrovato	retrouvé
silvio	silvio
agenti	agents
vizio	vice
precisione	précision
teologia	théologie
provincia	province
specialisti	spécialistes
permettere	permettre
scrittura	écriture
francoforte	francfort
aggiunte	ajoutées
rua	rue
buone	bonnes
piloti	pilotes
cittadino	citoyen
bordeaux	bordeaux
soggiorno	séjour
calibro	calibre
rivincita	revanche
tedesco	allemand
endemico	endémique
costumi	costumes
clienti	clients
quotidiano	quotidien
vietnam	vietnam
gestire	gérer
gianni	gianni
laterali	latéraux
specializzato	spécialisé
olandese	hollandais
natura	nature
corriere	courrier
evidenza	évidence
favore	faveur
secco	sec
giocatori	joueurs
economista	économiste
pellicola	pellicule
tradizioni	traditions
passeggeri	passagers
bernardo	bernard
madre	mère
cominciato	commencé
establishment	établissement
fondo	fond
cagliari	cagliari
trofeo	trophée
johnson	johnson
sociali	sociaux
elevato	élevé
unità	unité
contemporanei	contemporains
religiosa	religieuse
somma	somme
notato	noté
massacro	massacre
salvatore	sauveur
uk	uk
gustave	gustave
nascita	naissance
sintesi	synthèse
gesù	jésus
codice	code
terza	tierce
bambina	bambina
pokémon	pokémon
seguire	suivre
doppio	doppio
parole	paroles
professore	professeur
edoardo	édouard
chimico	chimiste
animazione	animation
rinascimento	renaissance
romeo	romeo
habitat	habitat
promosso	promu
franca	franche
occidente	occident
impiego	emploi
avere	avoir
california	california
andy	andy
edito	édité
diffusione	diffusion
outre	outre
abbreviazioni	abréviations
gregorio	grégoire
partito	parti
contribuire	contribuer
adattato	adapté
soprano	soprano
decina	dizaine
piuma	plume
socio	sociétaire
poeta	poète
newton	newton
giocare	jouer
eventualmente	éventuellement
trenta	trente
decesso	décès
pieve	pieve
tetto	toit
possedeva	possédait
cambiato	changé
tessuto	tissu
centro	centre
id	id
olio	huile
fallimento	faillite
prende	prends
curato	curé
attualmente	actuellement
motore	moteur
giovane	jeune
ulteriormente	ultérieurement
affresco	fresque
insegna	enseigne
illustrato	illustré
trono	trône
reazione	réaction
dottore	docteur
tenda	tente
chiaramente	clairement
ungherese	hongrois
leader	leader
dave	dave
ambasciata	ambassade
jr	jr
neri	noirs
tirante	tirant
villa	villa
principessa	princesse
localizzazione	localisation
seminario	séminaire
autonoma	autonome
indicato	indiqué
diocesi	diocèse
informazioni	informations
contrario	contraire
cacciatori	chasseurs
argento	argent
statistica	statistique
artificiale	artificiel
manifestazioni	manifestations
stato	état
uccidere	tuer
potenza	puissance
turistico	touristique
manga	manga
tommy	tommy
ingegnere	ingénieur
paola	paola
integrare	intégrer
vascello	vaisseau
piuttosto	plutôt
rispetto	respect
crimine	crime
nome	nom
evidente	évident
angolo	angle
cappella	chapelle
diffuso	diffus
apparecchio	appareil
enorme	énorme
obbligatoria	obligatoire
una	une
gatto	chat
giovanni	giovanni
ucciso	tué
programmi	programmes
romania	roumanie
facile	facile
rotta	route
costituzione	constitution
pianista	pianiste
avorio	ivoire
sarah	sarah
b	b
brasiliano	brésilien
santa	sainte
interno	intérieur
eredità	héritage
belli	beaux
chitarra	guitare
essenzialmente	essentiellement
egitto	égypte
redattore	rédacteur
cavalli	chevaux
medievale	médiéval
profondo	profond
paesaggi	paysages
israele	israël
px	px
neve	neige
sovietico	soviétique
umberto	umberto
fantastico	fantastique
dedicato	dédié
olimpico	olympique
norme	normes
aldo	aldo
attribuito	attribué
vittorie	victoires
medaglie	médailles
indiano	indien
nocciolo	noyau
archeologici	archéologiques
piede	pied
apparenza	apparence
russell	russell
predecessore	prédécesseur
org/w/index	org/w/index
basato	basé
arena	arène
venezia	venise
imperatore	empereur
pedro	pedro
stranieri	étrangers
parlato	parlé
alleanza	alliance
carta	carte
rappresentare	représenter
qualsiasi	quelconque
applicazione	application
alfonso	alfonso
atletica	athlétisme
norma	norme
economico	économique
utilizzare	utiliser
scoperto	découvert
elaborazione	élaboration
dibattiti	débats
sotto	sous
convenzione	convention
vivere	vivre
brescia	brescia
vs	vs
tuttavia	toutefois
settori	secteurs
cammino	chemin
uno	un
versailles	versailles
vicino	voisin
probabile	probable
arma	arme
gianfranco	gianfranco
ascendente	ascendant
personaggi	personnages
criteri	critères
quartiere	quartier
commento	commentaire
virginia	virginie
caratterizzata	caractérisée
marcatore	marqueur
clima	climat
ucraina	ukraine
talento	talent
gaetano	gaetano
rimasto	resté
memoria	mémoire
divenuto	devenu
governatore	gouverneur
romana	romaine
prototipo	prototype
anglaise	anglaise
aeroporto	aéroport
falso	faux
osservatorio	observatoire
solare	solaire
guerre	guerres
principale	principale
leggere	lire
moscou	moscou
politiche	politiques
essere	être
turismo	tourisme
qualificato	qualifié
porte	portes
terminata	terminée
due	deux
egli	il
morgan	morgan
dolce	douce
campi	champs
concilio	concile
specifiche	spécifications
celeste	céleste
fanteria	fantassin
www	www
coperto	couvert
gioco	jeu
proprietà	propriété
arcidiocesi	archidiocèse
cadere	tomber
nobiltà	noblesse
eclittica	écliptique
isère	isère
risoluzione	résolution
perse	perse
montagna	montagne
amore	amour
migliore	meilleur
morire	mourir
istituto	institut
valle	vallée
ragioni	raisons
participio	participe
villaggio	village
probabilmente	probablement
emma	emma
ritratto	portrait
africano	africain
espagnole	espagnole
patrono	patron
messaggio	message
comitato	comité
lingue	langues
violino	violon
belga	belge
louvre	louvre
trio	trio
segnali	signaux
matrimonio	mariage
lorenzo	lorenzo
oratorio	oratorio
emblema	emblème
morale	morale
questo	ceci
presenze	présences
religione	religion
remarkable	remarquable
campagna	campagne
hp	hp
stabile	stable
arrondissement	arrondissement
stoccolma	stockholm
discussione	discussion
pubblicato	publié
lombardo	lombard
deserto	désert
venti	vingt
decimo	dixième
definitivo	définitif
sito	site
strettamente	étroitement
élite	élite
tommaso	tommaso
deposito	dépôt
gradi	degrés
celebre	célèbre
rally	rallye
terme	thermes
marito	mari
volto	visage
porta	porte
attrice	actrice
importante	important
adesso	maintenant
treviso	treviso
hd	hd
siria	syrie
bryan	bryan
protezione	protection
preparare	préparer
museo	muséum
interessante	intéressant
governo	gouvernement
arco	arc
anna	anne
occupazione	occupation
potevano	pouvaient
quotidiana	quotidienne
bambino	bambin
caccia	chasse
vivo	vif
walter	walter
alex	alex
musica	musique
pesce	poisson
ospite	hôte
riforma	réforme
matteo	matteo
rischio	risque
sette	sept
contratto	contrat
motivazione	motivation
dite	dites
circuito	circuit
settembre	septembre
nemico	ennemi
dubbi	doutes
gravemente	gravement
attentato	attentat
colonna	colonne
inizio	commencement
olimpiade	olympiade
ritratti	portraits
atlante	atlas
condizioni	conditions
prodotti	produits
europei	européens
coro	chœur
tavolo	table
evitare	éviter
monarchia	monarchie
commerciale	commercial
proprio	propre
monastero	monastère
contribuzioni	contributions
precedente	précédent
sociale	social
latitudine	latitude
licenza	licence
sociologia	sociologie
confermato	confirmé
quasi	quasiment
croazia	croatie
mondo	monde
tomo	tome
ricco	riche
temi	thèmes
energia	énergie
ala	aile
perchè	pourquoi
harris	harris
comunicazione	communication
troviamo	trouvons
budapest	budapest
indipendenza	indépendance
posteriore	postérieur
apostolico	apostolique
fuso	fuseau
definire	définir
regolare	régulier
temperatura	température
tribunale	tribunal
modificato	modifié
muto	muet
animali	animaux
domicilio	domicile
concorrenza	concurrence
messina	messine
primario	primaire
origini	origines
titolo	titre
determinato	déterminé
attaccante	attaquant
agostino	augustin
sud	sud
parrocchiale	paroissiale
taglia	taille
sicilia	sicile
nelson	nelson
produrre	produire
conseguenze	conséquences
allievi	élèves
risultato	résultat
fornire	fournir
rd	rd
occidentali	occidentaux
convinto	convaincu
conquista	conquête
ragazze	filles
grasso	gras
sardegna	sardaigne
corta	courte
sogno	rêve
liberale	libéral
creare	créer
texas	texas
botswana	botswana
fedele	fidèle
genova	gênes
ricoperto	recouvert
televisivo	télévisuel
strumenti	instruments
bibliografia	bibliographie
parentesi	parenthèse
zucchero	sucre
moda	mode
jones	jones
barcellona	barcelone
terreni	terres
guinea	guinée
annuale	annuel
canne	cannes
romano	romain
semplificata	simplifiée
soldato	soldat
storia	histoire
valutazione	évaluation
mulino	moulin
parametro	paramètre
meglio	mieux
vincitori	vainqueurs
girolamo	jérôme
profondità	profondeur
poema	poème
campanile	campanile
punk	punk
ascolti	écoutes
emisfero	hémisphère
vandalismo	vandalisme
fratello	frère
bianca	blanche
organizzato	organisé
consigli	conseils
delegato	délégué
popolazioni	populations
piattaforma	plateforme
battaglione	bataillon
venire	venir
amante	amant
scoperta	découverte
scultura	sculpture
jpg	jpg
cifre	chiffres
uscire	sortir
magazzino	magasin
gérard	gérard
mayotte	mayotte
territoriale	territoriale
messicano	mexicain
presentare	présenter
carbonio	carbone
martin	martin
cavaliere	chevalier
opportunità	opportunité
privato	privé
marchio	marque
interessi	intérêts
clemente	clément
copertina	couverture
decisamente	décidément
portato	porté
passante	passant
variazione	variation
arrivati	arrivés
frequenti	fréquents
autorità	autorité
trasferimento	transfert
globo	globe
cooperazione	coopération
ix	ix
medaglia	médaille
lettore	lecteur
dottorato	doctorat
freccia	flèche
espresso	espresso
autonomia	autonomie
proteggere	protéger
aviazione	aviation
dei	des
concerti	concerts
iscritti	inscrits
ortodosso	orthodoxe
inclinazione	inclinaison
normandia	normandie
rifiuto	refus
diametro	diamètre
volo	vol
tema	thème
sostituito	remplacé
vetro	verre
catalogo	catalogue
fiore	fleur
sfruttamento	exploitation
indicare	indiquer
cassa	caisse
continua	continua
distrutto	détruit
modelli	modèles
fatto	fait
beni	biens
toronto	toronto
prefetto	préfet
eretta	érigée
occupata	occupée
sovrano	souverain
pechino	pékin
xixe	xixe
prefettura	préfecture
anonimo	anonyme
potenziale	potentiel
dama	dame
posizioni	positions
archeologico	archéologique
pensiero	pensée
liceo	lycée
padiglione	pavillon
cristianesimo	christianisme
colpi	coups
accompagnato	accompagné
azioni	actions
letteralmente	littéralement
pubbliche	publiques
lussemburgo	luxembourg
vittime	victimes
islamico	islamique
presentata	présentée
lavori	travaux
quai	quai
fabbricazione	fabrication
lanciatore	lanceur
componente	composant
arti	arts
enzo	enzo
scrittori	écrivains
png	png
macchina	machine
proposta	proposition
sostenuto	soutenu
kansas	kansas
besançon	besançon
industriale	industriel
finanze	finances
ferita	blessure
italia	italie
aquitania	aquitaine
contessa	comtesse
schermo	écran
fama	fama
psicologia	psychologie
civile	civil
occupato	occupé
circolazione	circulation
elemento	élément
lontano	lointain
bisogno	besoin
linee	lignes
qualità	qualité
dante	dante
messaggi	messages
rifiuti	déchets
composizione	composition
sorveglianza	surveillance
zona	zone
golfo	golfe
definizione	définition
sncf	sncf
modello	modèle
nono	neuvième
allevamento	élevage
archivio	archives
preferisce	préfère
partenza	départ
tre	trois
disputata	disputée
richiesta	demande
blasone	blason
ryan	ryan
dramma	drame
diritto	droit
ghiaccio	glace
basco	basque
libretto	livret
vocazione	vocation
geografia	géographie
destinato	destiné
ammissibilità	admissibilité
dinamica	dynamique
selvatico	sauvage
nonostante	nonobstant
giuridico	juridique
mistero	mystère
largamente	largement
ricompensa	récompense
errore	erreur
siracusa	syracuse
dischi	disques
tredici	treize
paragrafo	paragraphe
tesoro	trésor
introdotta	introduite
bello	beau
lorena	lorraine
federico	frédéric
virtù	vertu
pilota	pilote
ancora	ancre
andrea	andrea
filiale	filiale
sportiva	sportive
austriaca	autrichienne
record	record
dispositivo	dispositif
costa	côte
affidata	confiée
possibile	possible
nulla	nulle
responsabile	responsable
registrato	enregistré
mezzogiorno	midi
conservato	conservé
cercando	cherchant
stagione	saison
relazioni	relations
membro	membre
buona	bonne
morto	mort
piramide	pyramide
cagione	cause
kelly	kelly
istituita	instituée
barocco	baroque
unione	union
indicata	indiquée
valli	vallées
collega	collègue
automatico	automatique
battuta	battue
indipendente	indépendant
naturalmente	naturellement
avvenimento	événement
informazione	information,
ortografia	orthographe
contesto	contexte
quadrato	carré
ammiraglio	amiral
percorso	parcours
densità	densité
fiume	fleuve
miscela	mélange
capitano	capitaine
marcello	marcel
yves	yves
senato	sénat
popolazione	population
duo	duo
riuscire	réussir
individuale	individuel
fc	fc
funziona	fonctionne
cantoni	cantons
pubblici	publics
aperta	ouverte
clermont	clermont
partecipare	participer
firma	firme
strumento	instrument
limitato	limité
cinque	cinq
nantes	nantes
destinazione	destination
redazione	rédaction
avignone	avignon
ferroviario	ferroviaire
agosto	août
giacomo	giacomo
risposte	réponses
divenendo	devenant
capacità	capacité
chitarrista	guitariste
°c	°c
pianeti	planètes
agire	agir
vendita	vente
decreto	décret
ehess	ehess
costi	coûts
forma	forme
creato	créé
inutile	inutile
verrà	viendra
corso	cours
greco	grec
torrente	torrent
fondata	fondée
