если	if
озеро	lac
логика	logique
префект	préfet
серб	serbe
данные	données
junior	junior
метод	méthode
оксфорд	oxford
упражнение	exercice
станция	station
империя	empire
стекло	verre
свежий	frais
соседи	voisins
информация	information
предложенный	proposé
академия	académie
спасать	sauver
египет	égypte
проход	passage
anti	anti
диски	disques
библия	bible
синдром	syndrome
торонто	toronto
вариант	variante
бассейн	bassin
комплекс	complexe
оперы	opéras
эндемичный	endémique
advance	avance
возможности	possibilités
клетки	cellules
charlie	charlie
нормы	normes
проверять	vérifier
dordogne	dordogne
театр	théâtre
динамика	dynamique
сантьяго	santiago
цветок	fleur
алжир	algérie
цепь	chaîne
переиздание	réédition
говорить	parler
miami	miami
план	plan
альфонс	alphonse
процент	pourcentage
демократический	démocratique
христианство	christianisme
дополнительные	supplémentaires
предварительный	préalable
chansons	chansons
регион	région
пик	pic
уровни	niveaux
английский	anglais
бельгия	belgique
indre	indre
тексты	textes
ассоциирован	associé
князь	kniaz
engagement	engagement
деталь	détail
югославия	yougoslavie
освобождение	libération
скульптура	sculpture
мото	moto
гордон	gordon
топоним	toponyme
современники	contemporains
каролина	caroline
растения	plantes
помощь	aide
коллеги	collègues
рабочие	travailleurs
специфический	spécifique
бернард	bernard
издание	édition
залы	salles
отношения	relations
комментарий	commentaire
геннадий	gennadiy
орбита	orbite
анализ	analyse
век	siècle
разделение	séparation
функции	fonctions
,	,
генерация	génération
онтарио	ontario
supérieure	supérieure
madeleine	madeleine
официальный	officiel
болото	marais
принести	apporter
кислоты	acides
час	heure
лейпциг	leipzig
резолюция	résolution
северный	septentrional
hong	hong
капитан	capitaine
франшиза	franchise
бурбон	bourbon
темы	thèmes
зона	zone
gif	gif
метро	métro
елизавета	élisabeth
друзья	amis
трибунал	tribunal
континент	continent
код	code
императорский	impérial
бесполезный	inutile
глаза	yeux
араб	arabe
перо	plume
юридический	juridique
характер	caractère
мифология	mythologie
операция	opération
дуглас	douglas
филиппины	philippines
тогда	alors
журналист	journaliste
принципы	principes
анонс	annonce
семинар	séminaire
научный	scientifique
способности	capacités
озёра	lacs
мадрид	madrid
любовь	amour
софия	sofia
подготовка	préparation
марио	mario
кабинет	cabinet
отец	père
символ	symbole
монастырь	monastère
иллинойс	illinois
аномалия	anomalie
фауна	faune
репертуар	répertoire
мясо	viande
консервы	conserve
телевидение	télévision
достигать	atteindre
сергей	sergey
слава	gloire
оператор	opérateur
мотор	moteur
коммунист	communiste
партия	parti
скорость	vitesse
аниме	anime
монархия	monarchie
сооружать	construire
репродукция	reproduction
резерв	réserve
консенсус	consensus
культ	culte
вин	vin
израиль	israël
курица	poule
опубликованный	publié
кислота	acide
жанна	jeanne
сервис	service
надежда	espoir
румыния	roumanie
зрители	spectateurs
атмосфера	atmosphère
существование	existence
кредит	crédit
уникальный	unique
преступления	crimes
пребывание	séjour
тысяча	mille
лестница	escalier
explosion	explosion
гитлер	hitler
бегство	fuite
естественно	naturellement
вокзал	gare
студенты	étudiants
стиль	style
дмитриевич	dimitrievitch
robin	robin
япония	japon
солдаты	soldats
эквивалент	équivalent
цветы	fleurs
гражданский	civil
копивио	copivio
ручей	ruisseau
физическое	physique
мусульмане	musulmans
чемпионат	championnat
яковлевич	iakovlevitch
каждый	chacun
индивиду	individu
забастовка	grève
колледж	collège
ничего	rien
минута	minute
номинация	nomination
гамильтон	hamilton
резервы	réserves
карта	carte
индонезия	indonésie
епархия	éparchie
extreme	extrême
порто	porto
турне	tournée
ирина	irina
оригинальный	original
кость	os
конфликт	conflit
alain	alain
ситуация	situation
династии	dynasties
сочи	sotchi
новелла	nouvelle
услуги	services
индустриальный	industriel
статистика	statistique
алкоголь	alcool
бюро	bureau
итальянская	italienne
biografija	biographie
заметить	remarquer
жить	vivre
правый	droitier
продукты	produits
посредник	intermédiaire
курс	cours
открытый	ouvert
молчание	silence
аргентинский	argentin
европейский	européen
ложный	faux
факторы	facteurs
отсутствие	absence
этапы	étapes
растворение	dissolution
созданный	créé
принцесса	princesse
региональный	régional
специально	spécialement
avis	avis
небесный	céleste
счет	compte
газ	gaz
исключительно	exclusivement
пишут	écrivent
бейсбол	baseball
брест	brest
порядок	ordre
экономический	économique
кандидат	candidat
ремикс	remix
муниципалитеты	municipalités
участвовать	participer
министры	ministres
эдмонд	edmond
батальон	bataillon
граждане	citoyens
журналы	journaux
уровень	niveau
коммуникация	communication
актеры	acteurs
талант	talent
роберта	roberta
структура	structure
христианка	chrétienne
минск	minsk
бенжамин	benjamin
квентин	quentin
claude	claude
бульвар	boulevard
местности	localités
эффективный	efficace
цвет	couleur
годовщина	anniversaire
поколения	générations
svoboda	liberté
пирамида	pyramide
трудиться	travailler
независимые	indépendants
сумма	somme
туризм	tourisme
точность	précision
самоубийство	suicide
ядерный	nucléaire
институт	institut
исторические	historiques
помогать	aider
клиент	client
финляндский	finlandais
концентрация	concentration
длительность	durée
ассистент	assistant
дама	dame
стандарт	standard
ноты	notes
братья	frères
университет	université
маркиз	marquis
евро	euro
bordeaux	bordeaux
лингвистика	linguistique
сборник	recueil
доминирование	domination
венесуэла	venezuela
рукописи	manuscrits
могила	mogila
дать	donner
абсолютно	absolument
сеанс	séance
республика	république
google	google
бумага	papier
август	août
мексика	mexique
ресторан	restaurant
революционер	révolutionnaire
параллельно	parallèlement
феликс	félix
германский	germanique
буквально	littéralement
кириллица	cyrillique
тринадцать	treize
bruno	bruno
выбрать	choisir
комната	chambre
национальность	nationalité
мак	mac
экономические	économiques
различие	différence
альбом	album
путешествие	voyage
голос	voix
фотография	photographie
обязанности	devoirs
конкурс	concours
святые	saints
ребенок	enfant
калифорния	californie
значение	signification
графический	graphique
loire	loire
итальянцы	italiens
экономически	économiquement
энергии	énergies
обучение	enseignement
варианты	variantes
локальные	locales
этап	étape
классификация	classification
тюрьма	prison
конфедерация	confédération
ангел	ange
алексис	alexis
враги	ennemis
режим	régime
ставить	mettre
запуск	lancement
стороны	côtés
алтарь	autel
essence	essence
введение	introduction
драматург	dramaturge
иисус	jésus
жанры	genres
пауло	paulo
потребности	besoins
параметр	paramètre
экспедиция	expédition
clan	clan
обсуждать	discuter
булгария	bulgarie
мандат	mandat
нидерландский	néerlandais
культурная	culturelle
электрический	électrique
хотят	veulent
продвижение	promotion
экзамен	examen
знаменитый	célèbre
гренобль	grenoble
chemin	chemin
спортсмен	sportif
музыканты	musiciens
дворец	palais
универсальная	universelle
осужденный	condamné
возрождение	renaissance
командование	commandement
власть	pouvoir
харьков	kharkov
логотип	logo
православный	orthodoxe
секунда	seconde
ответственный	responsable
джейсон	jason
jpg	jpg
колумбия	colombie
литературный	littéraire
восьмой	huitième
равенство	égalité
здравствуй	bonjour
месторасположение	emplacement
жюри	jury
darkgrey	darkgrey
монпелье	montpellier
принцип	principe
генералы	généraux
rotation	rotation
зеленый	vert
дверь	porte
дневник	journal
surveillance	surveillance
километров	kilomètres
комиссар	commissaire
средневековая	médiévale
построенный	construit
христос	christ
республиканец	républicain
белград	belgrade
кадр	cadre
хотеть	vouloir
враг	ennemi
бригада	brigade
техас	texas
сокорро	socorro
martin	martin
сторона	côté
хронология	chronologie
свет	lumière
рельеф	relief
товары	marchandises
послать	envoyer
евгений	evgueni
сотрудничество	coopération
регулярная	régulière
плакат	affiche
миллион	million
chat	chat
хоккей	hockey
анжу	anjou
аквитания	aquitaine
телефон	téléphone
туннель	tunnel
андреевич	andreïevitch
литература	littérature
тема	thème
загруженный	chargé
читатель	lecteur
тренеры	entraîneurs
роза	rose
каледония	calédonie
bbc	bbc
математики	mathématiciens
реклама	publicité
акты	actes
пассажиры	passagers
трипл	triple
климат	climat
владельцы	propriétaires
император	empereur
кухня	cuisine
каталог	catalogue
выставка	exposition
южный	southern
машина	machine
лучше	mieux
максимум	maximum
философ	philosophe
ветвь	branche
пятьдесят	cinquante
математик	mathématicien
isbn	isbn
принятый	accepté
выражение	expression
кузен	cousin
participation	participation
эрик	éric
duo	duo
латинский	latin
работают	travaillent
папа	papa
стефан	stéphane
сервер	serveur
кафе	café
рейх	reich
татьяна	tatiana
сделайте	faites
обмен	échange
объяснять	expliquer
серии	séries
пятница	vendredi
риск	risque
улучшение	amélioration
женщина	femme
мануэль	manuel
волк	loup
конкретно	concrètement
конференции	conférences
оценка	évaluation
португалец	portugais
служить	servir
федерации	fédérations
потенциал	potentiel
тони	toni
сестра	sœur
семёнович	semionovitch
влюбленный	amoureux
плотность	densité
серия	série
лиги	ligues
академии	académies
flora	flore
ian	ian
brun	brun
римский	romain
марш	marche
равновесие	équilibre
потомки	descendants
предыдущий	précédent
игроки	joueurs
вилла	villa
канадский	canadien
драконы	dragons
созвездие	constellation
лицензия	licence
вашингтон	washington
иллюстрация	illustration
комиссия	commission
французский	français
ученик	élève
барон	baron
форум	forum
инициатива	initiative
готический	gothique
бюллетень	bulletin
мощный	puissant
вероятный	probable
провинция	province
романтический	romantique
этюд	étude
испанский	espagnol
собака	chien
галерея	galerie
хорватия	croatie
вдова	veuve
роль	rôle
болезнь	maladie
україна	ukraine
греция	grèce
молодые	jeunes
японская	japonaise
этаж	étage
рано	tôt
обычно	habituellement
соль	sel
участники	participants
новые	nouveaux
студент	étudiant
пятнадцать	quinze
rgb	rgb
константинович	constantinovitch
диск	disque
собственность	propriété
адам	adam
епископ	évêque
сестры	sœurs
портал	portail
годовой	annuel
феномен	phénomène
святилище	sanctuaire
доктор	docteur
католики	catholiques
колония	colonie
библиотеки	bibliothèques
церковь	église
компания	compagnie
microsoft	microsoft
регионы	régions
динамо	dynamo
космос	cosmos
африка	afrique
биографический	biographique
чикаго	chicago
цивилизация	civilisation
доллары	dollars
кардинал	cardinal
победы	victoires
специализированный	spécialisé
серебро	argent
федеральный	fédéral
путешественники	voyageurs
правило	règle
рыба	poisson
johann	johann
финалист	finaliste
нельсон	nelson
канада	canada
королева	reine
ричард	richard
поведение	comportement
лауреат	lauréat
origines	origines
новый	nouveau
телесериал	télésérie
hervé	hervé
оливье	olivier
совесть	conscience
\frac	\frac
камерун	cameroun
программа	programme
медаль	médaille
красивый	beau
крыло	aile
умереть	mourir
элемент	élément
изученный	étudié
играют	jouent
солнце	soleil
✉	✉
временно	temporairement
конгресс	congrès
приобретение	acquisition
сержант	sergent
ирландия	irlande
население	population
салон	salon
сирия	syrie
фильмы	films
xv	xv
резиденция	résidence
мрамор	marbre
бюджет	budget
листья	feuilles
эпоним	éponyme
лошади	chevaux
инвентарь	inventaire
полуостров	péninsule
петербург	pétersbourg
политика	politique
церемония	cérémonie
уголь	charbon
технология	technologie
токио	tokyo
ryan	ryan
кампании	campagnes
модифицированный	modifié
лукас	lucas
административно	administrativement
вероятно	vraisemblablement
фасад	façade
отвечать	répondre
contributions	contributions
звезда	étoile
иллюстрации	illustrations
хроника	chronique
люблин	lublin
платформа	plateforme
царствование	règne
савойя	savoie
сигнал	signal
коммерческая	commerciale
результат	résultat
шампанское	champagne
активный	actif
собственно	proprement
этажи	étages
стихотворение	poème
планеты	planètes
brunswick	brunswick
строительство	construction
симон	simon
минор	mineur
шеф	chef
уважение	respect
потерянный	perdu
мельница	moulin
купол	dôme
леон	léon
исполнитель	exécutant
олег	oleg
аргументы	arguments
руины	ruines
автомобиль	automobile
хуже	pire
генетика	génétique
жертва	victime
наделённый	doté
кастилия	castille
организация	organisation
демарш	démarche
жертвы	victimes
лаборатории	laboratoires
актуальный	actuel
дебит	débit
современник	contemporain
клип	clip
честь	honneur
гитарист	guitariste
запись	enregistrement
безопасность	sécurité
испания	espagne
атлетика	athlétisme
пираты	pirates
административный	administratif
географии	géographies
масло	huile
дисней	disney
opus	opus
альпы	alpes
kevin	kevin
военный	militaire
регби	rugby
упоминание	mention
ритм	rythme
порт	port
дизайн	design
маленький	petit
формулы	formules
организованный	organisé
роланд	roland
четверть	quart
нос	nez
фильм	film
профессионалы	professionnels
энергия	énergie
пляж	plage
фрукты	fruits
жанр	genre
проходящий	passant
uns	uns
определять	déterminer
фёдорович	fiodorovitch
баптист	baptiste
исполнители	exécutants
кантоны	cantons
марс	mars
совет	conseil
уважать	respecter
химия	chimie
платформы	plateformes
музыкант	musicien
герцог	duc
xls	xls
экватор	équateur
предмет	objet
вопросы	questions
фраза	phrase
трудность	difficulté
парламент	parlement
спасибо	merci
прованс	provence
важность	importance
jr	jr
протокол	protocole
фразы	phrases
неизвестная	inconnue
депутат	député
традиционный	traditionnel
jerry	jerry
географический	géographique
отъезд	départ
фердинанд	ferdinand
вкус	goût
писатель	écrivain
альбомы	albums
семья	famille
телесериалы	téléséries
enciklopedija	encyclopédie
мальчики	garçons
газета	gazette
купе	coupe
легкий	léger
организм	organisme
воль	vol
парк	parc
госпиталь	hôpital
зал	salle
мот	mot
сфера	sphère
реформы	réformes
монах	moine
iso	iso
запланированный	prévu
магазин	magasin
частный	privé
транспорты	transports
утверждение	affirmation
изучать	étudier
комический	comique
дружба	amitié
константинополь	constantinople
норма	norme
юлия	julia
домены	domaines
jeff	jeff
голливуд	hollywood
галло	gallo
фото	photo
jimmy	jimmy
джонсон	johnson
археология	archéologie
полк	régiment
реформа	réforme
николя	nicolas
образование	education
королевство	royaume
спутник	satellite
анна	anna
революция	révolution
бот	bot
писа́ть	écrire
сеть	réseau
possible	possible
норвежский	norvégien
наука	science
реставрация	restauration
европейцы	européens
июнь	juin
история	histoire
пилоты	pilotes
воля	volonté
контроль	contrôle
сценарист	scénariste
вооружение	armement
синий	bleu
nancy	nancy
слова	mots
снег	neige
армия	armée
профессия	profession
автономия	autonomie
текст	texte
секс	sexe
трофей	trophée
бразилия	brésil
спорт	sport
dave	dave
жизнь	жизнь
гастон	gaston
видимые	visibles
профессор	professeur
франция	france
раненый	blessé
серьезный	sérieux
стокгольм	stockholm
социальный	social
интеграция	intégration
antiquity	antiquité
минуты	minutes
христианский	chrétien
кризис	crise
характеристики	caractéristiques
лиссабон	lisbonne
медицина	médecine
теории	théories
оккупировать	occuper
макс	max
география	géographie
эксперименты	expériences
следующий	suivant
мур	mur
продукт	produit
мирный	pacifique
георгия	géorgie
поиск	recherche
корабли	navires
исчезнувший	disparu
астероид	astéroïde
военные	militaires
астероиды	astéroïdes
базилика	basilique
социалист	socialiste
благоприятный	favorable
министерство	ministère
условия	conditions
андерсон	anderson
предприятия	entreprises
глубина	profondeur
канадцы	canadiens
chili	chili
расстояние	distance
четвёртый	quatrième
орфография	orthographe
секретарь	secrétaire
тридцать	trente
франк	franc
частично	partiellement
ламберт	lambert
чемпионка	championne
программирование	programmation
волны	vagues
турк	turc
суббота	samedi
полезный	utile
крепость	forteresse
rayon	rayon
вариация	variation
тенденция	tendance
фонд	fond
здание	bâtiment
карьеры	carrières
сердца	cœurs
лаборатория	laboratoire
октябрь	octobre
потерять	perdre
острова	îles
дополнительный	supplémentaire
независимая	indépendante
схема	schéma
кембридж	cambridge
консерватор	conservateur
конституция	constitution
колодец	puits
мечта	rêve
тяжёлый	lourd
соответствие	correspondance
переговоры	négociations
посольство	ambassade
productions	productions
ирландский	irlandais
сценарий	scénario
валентность	valence
реконструкция	reconstruction
религии	religions
предшественник	prédécesseur
химический	chimique
формула	formule
фантастический	fantastique
loneos	loneos
вики	wiki
стены	murs
частота	fréquence
зависимости	dépendances
вторжение	invasion
понедельник	lundi
рабы	esclaves
брак	mariage
исламский	islamique
предлагать	proposer
производить	produire
пожар	incendie
барокко	baroque
тренировка	entraînement
uss	uss
ffffff	ffffff
память	mémoire
шпага	épée
lausanne	lausanne
церкви	églises
атлантический	atlantique
необходимость	nécessité
панк	punk
двойной	double
весна	printemps
красный	rouge
сказки	contes
редакция	rédaction
тулон	toulon
армения	arménie
покупка	achat
агенты	agents
хлеб	pain
модификация	modification
оккупированный	occupé
победа	victoire
гитара	guitare
медали	médailles
бунт	révolte
uefa	uefa
бургундия	bourgogne
независимость	indépendance
ожидать	attendre
фиат	fiat
мадагаскар	madagascar
локализация	localisation
австрия	autriche
пятый	cinquième
репутация	réputation
аниматор	animateur
телефильм	téléfilm
филиал	filiale
июль	juillet
независимый	indépendant
клуб	club
звезды	étoiles
авраам	abraham
профиль	profil
эрнест	ernest
депутаты	députés
приключения	aventures
арденны	ardennes
приключение	aventure
александровна	alexandrovna
болезни	maladies
координаты	coordonnées
рассказы	récits
пиренеи	pyrénées
норвегия	norvège
диалог	dialogue
наконец	enfin
традиционная	traditionnelle
берлин	berlin
финансы	finances
наследие	héritage
демографический	démographique
коллективный	collectif
%be%d	%be%d
миннесота	minnesota
батарея	batterie
древесина	bois
ясный	clair
фотографии	photographies
монтаж	montage
декларация	déclaration
мост	pont
механизм	mécanisme
rhône	rhône
финляндия	finlande
davis	davis
цикл	cycle
созданная	créée
эпоха	époque
центр	centre
класс	classe
мэр	maire
трамвай	tramway
общество	société
футбол	football
циркуляция	circulation
hommage	hommage
екатерина	ekaterina
яков	iakov
древо	arbre
центры	centres
миллиарды	milliards
наследник	héritier
жидкость	liquide
консерватории	conservatoires
освобожденный	libéré
pseudo	pseudo
буржуа	bourgeois
евреи	juifs
красные	rouges
полюс	pôle
партизаны	partisans
капелла	chapelle
конференция	conférence
манифестация	manifestation
форма	forme
boris	boris
коммунисты	communistes
украинская	ukrainienne
аккорды	accords
морган	morgan
специфические	spécifiques
церемонии	cérémonies
союзники	alliés
вода	eau
планета	planète
май	mai
человеческий	humain
альфред	alfred
утро	matin
оптика	optique
василий	vassili
цифры	chiffres
академик	académicien
администратор	administrateur
пост	post
община	communauté
актуальность	actualité
арбитр	arbitre
исполнительный	exécutif
инструмент	instrument
арка	arc
авторитет	autorité
fernand	fernand
контекст	contexte
финансист	financier
энциклопедический	encyclopédique
полицейский	policier
проблемы	problèmes
крыша	toit
общины	communautés
several	plusieurs
телефонный	téléphonique
литературные	littéraires
svg	svg
идентичность	identité
белые	blancs
антон	anton
редактор	rédacteur
отдельно	séparément
верить	croire
информатика	informatique
рефлексия	réflexion
солид	solide
production	production
философия	philosophie
антуан	antoine
communications	communications
дополнение	supplément
понимать	comprendre
jersey	jersey
вокруг	autour
окончательно	définitivement
американцы	américains
дисциплина	discipline
представления	représentations
скоро	bientôt
нефть	pétrole
автомагистраль	autoroute
белый	blanc
открытия	découvertes
секторы	secteurs
запрещённый	interdit
иерусалим	jérusalem
интернет	internet
тренер	entraîneur
анимация	animation
параллель	parallèle
платить	payer
дух	esprit
активность	activité
баллон	ballon
отходы	déchets
семьи	familles
шахматы	échecs
yves	yves
турнир	tournoi
частная	privée
футболист	footballeur
закон	loi
нидерландская	néerlandaise
хочет	veut
месяц	mois
критика	critique
документы	documents
выход	sortie
архитектор	architecte
архитектура	architecture
предметы	objets
католик	catholique
науки	sciences
портреты	portraits
события	événements
конструктор	constructeur
монета	monnaie
сенегал	sénégal
добровольцы	volontaires
канал	canal
hugo	hugo
файл	fichier
элементы	éléments
механика	mécanique
karl	karl
официальные	officielles
министр	ministre
туристический	touristique
даниэль	daniel
современная	contemporaine
окрестности	environs
спортсмены	sportifs
преступление	crime
презентация	présentation
наполеон	napoléon
каноны	canons
реально	réellement
флаг	drapeau
квартал	quartier
корея	corée
украинский	ukrainien
биржа	bourse
казахстан	kazakhstan
инкубатор	incubateur
ваш	votre
ключ	clé
статуи	statues
континентальный	continental
доказательство	preuve
oblast	oblast
праздник	fête
степень	degré
начинать	commencer
типография	imprimerie
neutral	neutre
англия	angleterre
фёдор	fiodor
копия	copie
восстановление	rétablissement
окна	fenêtres
квалифицированный	qualifié
закрытая	fermée
азия	asie
grosse	grosse
скульптор	sculpteur
лев	lion
автоматический	automatique
словарь	dictionnaire
предположительно	supposément
документальный	documentaire
контакт	contact
александр	alexandre
линия	ligne
гильберт	gilbert
александра	alexandra
исторический	historique
метрополия	métropole
дождь	pluie
исчезновение	disparition
альпийский	alpin
двадцать	vingt
экспедиции	expéditions
входить	entrer
италия	italie
мвд	mvd
монреаль	montréal
смесь	mélange
температура	température
прокурор	procureur
берег	bereg
доход	revenu
инженеры	ingénieurs
xvii	xvii
аргумент	argument
столица	capitale
положение	position
инспектор	inspecteur
колонка	colonne
холод	froid
автоматически	automatiquement
активы	actifs
местность	localité
павла	pavla
важный	important
предшествующая	précédente
англичанка	anglaise
процедура	procédure
документ	document
зима	hiver
правая	droite
приблизительно	approximativement
угол	angle
девятый	neuvième
земля	terre
продолжать	continuer
вирджиния	virginie
intelligence	intelligence
пространство	espace
municipal	municipal
surprise	surprise
поражение	défaite
гражданин	citoyen
полковник	colonel
пейзаж	paysage
друг	ami
corse	corse
животное	animal
монако	monaco
стадион	stade
священный	sacré
птицы	oiseaux
луиза	louise
иерархия	hiérarchie
ограниченный	limité
японский	japonais
влияние	influence
крест	croix
простые	simples
вход	entrée
консультировать	consulter
винсент	vincent
ольга	olga
кандидатура	candidature
улучшать	améliorer
сектор	secteur
верный	fidèle
положительный	positif
агентство	agence
альберт	albert
оппозиция	opposition
навязывать	imposer
старый	vieux
уимблдон	wimbledon
чемпион	champion
диаметр	diamètre
тяжёлые	lourds
ванкувер	vancouver
религиозная	religieuse
оценивать	évaluer
еврей	juif
падать	tomber
перенаправление	redirection
музыкальные	musicales
бостон	boston
прогресс	progrès
самуэль	samuel
синтез	synthèse
origine	origine
справедливо	justice
парижский	parisien
святой	saint
администраторы	administrateurs
свободные	libres
фортепиано	pianoforte
арестовать	arrêter
html	html
апрель	avril
бельгийский	belge
четырнадцать	quatorze
альберто	alberto
британский	britannique
африканский	africain
олимпийский	olympique
испытания	épreuves
ним	nim
формально	formellement
кантон	canton
волосы	cheveux
сербия	serbie
играть	jouer
студия	studio
труд	travail
секции	sections
эдгар	edgar
итальянский	italien
композитор	compositeur
знаменитые	célèbres
река	rivière
мобильный	mobile
навигация	navigation
промышленность	industrie
engage	engage
содержание	contenu
новеллы	nouvelles
данный	donné
редукция	réduction
представление	représentation
антонио	antonio
вандализм	vandalisme
как	comme
генерал	général
манчестер	manchester
словакия	slovaquie
индекс	index
конкуренция	concurrence
номинации	nominations
миллионы	millions
карты	cartes
цезарь	césar
oriental	oriental
собор	cathédrale
фернандо	fernando
библиотека	bibliothèque
дискурс	discours
событие	événement
воскресенье	dimanche
атаки	attaques
искусство	art
культуры	cultures
интервью	interview
афины	athènes
римляне	romains
эмиссия	émission
мотив	motif
блюз	blues
удовольствие	plaisir
небо	ciel
арманд	armand
запрещение	interdiction
рождение	naissance
преимущественно	principalement
выбор	choix
январь	janvier
технологии	technologies
заключённые	prisonniers
стратегия	stratégie
сенат	sénat
двенадцать	douze
реализация	réalisation
иосиф	iosif
leader	leader
адмирал	amiral
здания	bâtiments
продвигать	promouvoir
атакующий	attaquant
электрические	électriques
фридрих	friedrich
резюме	résumé
интервики	interwikis
пауки	araignées
указывать	indiquer
бретань	bretagne
iii	iii
командовал	commandait
asp	asp
подпись	signature
руссильон	roussillon
душа	âme
могли	pouvaient
суверенный	souverain
регулярно	régulièrement
племянник	neveu
защитник	défenseur
атлас	atlas
прибыть	arriver
журналисты	journalistes
декрет	décret
августин	augustin
федеральная	fédérale
участник	participant
улицы	rues
испанцы	espagnols
внимание	attention
виктория	victoria
бис	bis
филадельфия	philadelphie
секция	section
квалификация	qualification
крылья	ailes
иван	ivan
конгрегация	congrégation
локальный	local
роберт	robert
теорема	théorème
валентин	valentine
препятствовать	empêcher
трактат	traité
личность	personnalité
сахар	sucre
солдат	soldat
австрийский	autrichien
манифест	manifeste
февраль	février
экология	écologie
группа	groupe
труппа	troupe
газеты	gazettes
xii	xii
факультет	faculté
специализированная	spécialisée
roger	roger
кавалеры	cavaliers
отставка	retraite
закрытый	fermé
физики	physiciens
посвящённая	consacrée
энтальпия	enthalpie
психология	psychologie
дикий	sauvage
тёмный	sombre
сравнение	comparaison
китайская	chinoise
запрашивать	demander
игрок	joueur
торговля	commerce
дети	enfants
пилот	pilote
элита	élite
рассказ	récit
свидетель	témoin
рыбы	poissons
статус	statut
денис	denis
западный	occidental
международный	international
адаптирован	adapté
инфобокс	infobox
археологический	archéologique
арагон	aragon
обязательный	obligatoire
проходят	passent
часто	fréquemment
педагог	pédagogue
сайты	sites
велосипедист	cycliste
бронза	bronze
защищать	protéger
делегация	délégation
поворачивать	tourner
война	guerre
категория	catégorie
бразильский	brésilien
читатели	lecteurs
колокольня	clocher
антенна	antenne
профессиональный	professionnel
чемпионы	champions
дональд	donald
карьера	career
вестник	vestnik
paradise	paradis
север	nord
осень	automne
типы	types
квебекский	québécois
декабрь	décembre
известность	notoriété
архиепископ	archevêque
лаваль	laval
оркестр	orchestre
интересный	intéressant
jordan	jordan
знаки	signes
маска	masque
варшава	varsovie
центральный	central
what	quoi
спам	spam
актер	acteur
вирус	virus
счастье	bonheur
банк	banque
епископы	évêques
почему	pourquoi
двигатели	moteurs
флот	flotte
материалы	matériaux
лейтенант	lieutenant
традиционно	traditionnellement
равнина	plaine
канадская	canadienne
поезд	train
заменять	remplacer
клиенты	clients
sarah	sarah
дискуссия	discussion
php	php
тур	tour
интегрировать	intégrer
королевский	royal
павильон	pavillon
камень	caillou
святая	sainte
глобус	globe
риски	risques
делегат	délégué
турция	turquie
страницы	pages
демократия	démocratie
приближение	approche
луна	lune
комедия	comédie
актриса	actrice
мэрия	mairie
португалия	portugal
физико	physico
династия	dynastie
христиане	chrétiens
открытая	ouverte
аббатство	abbaye
модели	modèles
лист	feuille
социология	sociologie
аббат	abbé
викторович	viktorovitch
симфония	symphonie
проект	projet
реакция	réaction
кристаллы	cristaux
fountain	fontaine
испытание	épreuve
радио	radio
бонапарт	bonaparte
дипломированный	diplômé
день	jour
коалиция	coalition
мемуары	mémoires
красота	beauté
простой	simple
опыт	expérience
киев	kiev
sncf	sncf
америка	amérique
уничтожать	détruire
пещера	grotte
офицеры	officiers
леопольд	léopold
писатели	écrivains
личный	personnel
юниоры	juniors
крестьяне	paysans
тунис	tunisie
оккупация	occupation
клермон	clermont
агент	agent
википедия	wikipédia
производитель	producteur
евгения	eugénie
советские	soviétiques
пианист	pianiste
драма	drame
австралиец	australien
федерация	fédération
противоположный	opposé
камиль	camille
экономика	économie
ответ	réponse
инженер	ingénieur
животные	animaux
выйти	sortir
законы	lois
конвенция	convention
минимум	minimum
консул	consul
близость	proximité
создатель	créateur
артиллерия	artillerie
idem	idem
культурный	culturel
редкий	rare
марина	marina
библиография	bibliographie
маршал	maréchal
никогда	jamais
оскар	oscar
докторская	doctorat
глаз	œil
король	roi
париж	paris
коммерческий	commercial
австралия	australie
религия	religion
эволюция	évolution
territory	territoire
xviii	xviii
предложения	propositions
член	membre
четыре	quatre
сицилия	sicile
fred	fred
оставленный	abandonné
преподаватели	professeurs
восемь	huit
инструменты	instruments
патрик	patrick
корень	racine
вит	vit
комментарии	commentaires
медь	cuivre
ответственность	responsabilité
обязательно	obligatoirement
валентина	valentina
павлович	pavlovitch
предупреждение	avertissement
пекин	pékin
григорьевич	grigorievitch
миссия	mission
midi	midi
следуют	suivent
милан	milan
парламентский	parlementaire
авиньон	avignon
гражданство	citoyenneté
будапешт	budapest
подготовить	préparer
устойчивый	durable
эльзас	alsace
следовать	suivre
опубликованная	publiée
флорида	floride
константа	constante
права	droits
школы	écoles
вторичный	secondaire
апостольский	apostolique
герцогиня	duchesse
неаполь	naples
детство	enfance
введенный	introduit
наклон	inclinaison
поддерживать	soutenir
шарлотта	charlotte
оценки	évaluations
павел	pavel
вдохновение	inspiration
экран	écran
комитет	comité
море	mer
экипировка	équipement
молодёжный	jeune
девочки	filles
йорк	york
xavier	xavier
блок	bloc
остров	île
фотограф	photographe
лондон	londres
трудности	difficultés
страница	page
джонни	johnny
jules	jules
префектура	préfecture
сопротивление	résistance
клемент	clément
бронзовый	bronzé
трафик	trafic
якоб	jacob
компетенции	compétences
аппарат	appareil
спектакль	spectacle
интервенция	intervention
доступный	accessible
ислам	islam
станислав	stanislas
канон	canon
inde	inde
цвета	couleurs
лувр	louvre
дамы	dames
кольцо	anneau
квадрат	carré
carl	carl
диджей	dj
первичная	primaire
путешествия	voyages
the	the
кореец	coréen
содержит	contient
международные	internationales
либеральный	libéral
региональные	régionales
нормандия	normandie
высокий	haut
восстановить	rétablir
мадам	madame
знать	savoir
оао	оао
биология	biologie
период	period
атаковать	attaquer
заменённый	remplacé
коллега	collègue
дополнить	compléter
молоко	lait
naturelle	naturelle
brian	brian
характеристика	caractéristique
бавария	bavaria
корабль	navire
политик	politicien
владеет	possède
ориентация	orientation
искать	chercher
государство	état
происходящий	provenant
потребление	consommation
упразднен	supprimé
цифровой	numérique
ноябрь	novembre
трудный	difficile
визит	visite
кавалерия	cavalerie
пехота	infanterie
жёлтый	jaune
короткая	courte
герцеговина	herzégovine
греки	grecs
псевдоним	pseudonyme
cn	cn
партнер	partenaire
иванов	ivanov
алиса	alice
эмблема	emblème
электричество	électricité
календарь	calendrier
алан	alan
сцены	scènes
интерьер	intérieur
продажа	vente
россия	russie
одиннадцать	onze
переведенный	traduit
невозможно	impossible
ошибка	erreur
здоровье	santé
советники	conseillers
портрет	portrait
cf	cf
снаружи	dehors
индеец	indien
версаль	versailles
тибет	tibet
кварталы	quartiers
прыжок	saut
мотивы	motifs
рынок	marché
личности	personnalités
официально	officiellement
мастерская	atelier
флоренция	florence
хан	khan
движение	mouvement
frank	frank
кафедра	cathedra
линии	lignes
царь	tsar
аэропорт	aéroport
png	png
награды	récompenses
паломар	palomar
ботаника	botanique
колонии	colonies
лицей	lycée
пикардия	picardie
синдикат	syndicat
гипотеза	hypothèse
практика	pratique
феррари	ferrari
претензии	prétentions
требования	exigences
мужской	masculin
кампус	campus
возможность	possibilité
завещание	testament
условие	condition
иванович	ivanovitch
умеренно	modérément
документация	documentation
степанович	stepanovitch
жорж	georges
издатель	éditeur
цепи	chaînes
деноминация	dénomination
природа	nature
ревю	revue
николаевна	nikolaïevna
интересы	intérêts
работник	travailleur
org/w/index	org/w/index
теннис	tennis
фм	fm
otto	otto
окно	fenêtre
константин	constantin
кирилл	cyrille
предложение	proposition
взрослый	adulte
диплом	diplôme
природный	naturel
алекс	alex
комплексы	complexes
usa	usa
немцы	allemands
касса	caisse
обвинения	accusations
блог	blog
влади́мир	vladimir
добавленный	ajouté
маршан	marchand
финансирование	financement
растение	plante
модель	modèle
quality	qualité
увеличить	augmenter
идентификатор	identifiant
атака	attaque
формат	format
корпорация	corporation
балет	ballet
битва	bataille
организмы	organismes
parents	parents
ежегодно	annuellement
судебный	judiciaire
носить	porter
школа	école
villeneuve	villeneuve
планы	plans
всегда	toujours
лаврентий	laurent
океан	océan
амстердам	amsterdam
люксембург	luxembourg
сенатор	sénateur
томас	thomas
теория	théorie
ютуб	youtube
русский	russe
программы	programmes
адаптация	adaptation
игры	jeux
carlo	carlo
лионский	lyonnais
артур	arthur
губернатор	gouverneur
доверие	confiance
архипелаг	archipel
посол	ambassadeur
solo	solo
методы	méthodes
электронный	électronique
экземпляры	exemplaires
сердце	cœur
секунды	secondes
мельницы	moulins
прийти	venir
султан	sultan
домен	domaine
организации	organisations
gorod	ville
кандидаты	candidats
гостиница	hôtel
illustrious	illustre
форт	fort
операции	opérations
столицы	capitales
легенда	légende
эдуард	édouard
доктрина	doctrine
техника	technique
поляк	polonais
джованни	giovanni
архивы	archives
dvd	dvd
цитировать	citer
брюссель	bruxelles
музыкальный	musical
обсерватория	observatoire
описание	description
коммуна	commune
иконы	icônes
демократ	démocrate
переименовать	renommer
сентябрь	septembre
нормальная	normale
кампания	campagne
смерть	mort
noblesse	noblesse
праздники	fêtes
souvenirs	souvenirs
мало	malo
ты	tu
russell	russell
венгерский	hongrois
лауреаты	lauréats
эпизоды	épisodes
дракон	dragon
знания	connaissances
обвиняемый	accusé
стол	table
популярность	popularité
музыка	musique
греческий	grec
орлеан	orléans
раненые	blessés
религиозный	religieux
эффективность	efficacité
москва	moscou
толкование	interprétation
текущий	courant
избегать	éviter
поверхность	surface
длинный	long
мертвые	morts
вдохновлен	inspiré
автор	auteur
возвращаться	revenir
каждая	chacune
одежда	vêtements
птица	oiseau
мода	mode
авторитеты	autorités
страсбург	strasbourg
должны	doivent
офицер	officier
советский	sovietique
атлет	athlète
представленный	présenté
акцент	accent
корреспондент	correspondant
борьба	lutte
арбитраж	arbitrage
принимать	accepter
ответы	réponses
декорация	décoration
интегрированный	intégré
создать	créer
близкие	proches
